3d_glasses	Three-D Glasses
3d_movie	Three-D Movie
a	A
a_m_1	AM - time 1
a_m_2	AM - time 2
abbreviate	Abbreviate
abc_s	ABCs
abdomen	Abdomen
able	Able
abort	Abort
about	About - All Around
above_2	Above
absent	Absent
abstract	Abstract
abuse	Abuse
academic	Academic
accept	Accept
acceptance_letter_college	Acceptance Letter - College
accident_1car	Accident - Car
accident_2	Accident - 1
accident_3	Accident - 2
accompany	Accompany
accomplish	Accomplish
accordian	Accordian
account	Account - Financial
accountant	Accountant
accuse	Accuse
ache	Ache
achieve	Achieve
acid	Acid
acquaint	Acquaint
acrobat	Acrobat
across	Across
act	Act - Perform
actor	Actor
actress	Actress
acupuncture	Acupuncture
acute	Acute
adapt	Adapt
add	Add
addition	Addition
address	Address - Street
adhesive	Adhesive
adjective	Adjective
adjust	Adjust
administrator	Administrator
admire	Admire
admit	Admit - Confess
adolescent	Adolescent
adopt	Adopt
adult	Adult
advance	Advance
advantage	Advantage
adventure	Adventure
adverb	Adverb
advertise	Advertise
advertisement	Advertisement
advice	Advice
advise	Advise
aerospace_engineer	Aerospace Engineer
affect	Affect
affiliate	Affiliate
affirm	Affirm
affliction_1	Affliction - 1
affliction_2	Affliction - 2
afraid	Afraid
africa_1	Africa - 1
africa_2	Africa - 2
african_1	African - Race - 1
african_2	African - Race - 2
african_3	African - Race - 3
after	After
afternoon	Afternoon
afternoon_discount	Afternoon Discount
again	Again
against	Against
age	Age
agenda	Agenda
aggress	Aggress
aggression	Aggression
aging	Aging
ago	Ago
agree	Agree
agriculture	Agriculture
ahead	Ahead
aid	Aid
ail	Ail
aim	Aim
air	Air
air_blower	Air Blower
air_compressor	Air Compressor
air_compressor_hose	Air Compressor Hose
air_condition	Air Condition
air_pressure	Air Pressure
air_sickness	Air Sickness
air_traffic_controller	Air Traffic Controller
air_travel	Air Travel
airforce	Airforce
airline_food	Airline Food
airline_music	Airline Music
airline_passenger	Airline Passenger
airline_ticket	Airline Ticket
airplane	Airplane
airplane_boarding	Airplane Boarding
airport	Airport
airport_attendant	Airport Attendant
airport_entrance	Airport Entrance
airport_exit	Airport Exit
airport_food	Airport Food
airport_information	Airport Information
airport_janitor	Airport Janitor
airport_metal_detector	Airport Metal Detector
airport_prices	Airport Prices
airport_security	Airport Security
airport_terminal	Airport Terminal
airport_traffic_cars	Airport Traffic - Cars
airport_traffic_planes	Airport Traffic - Planes
airport_tram	Airport Tram
alabama	Alabama
alarm	Alarm - Bell
alarm_clock	Alarm Clock
alaska_1	Alaska - 1
alaska_2	Alaska - 2
album	Album
alcohol	Alcohol
alcoholism	Alcoholism
alert	Alert
alfalfa	Alfalfa
algae	Algae
algebra	Algebra
alike	Alike
alive	Alive
all	All
all_turns_left_lane	All Turns Left Lane
all_turns_right_lane	All Turns Right Lane
allegiance	Allegiance
allen_bolt	Allen Bolt
allergy	Allergy
alligator	Alligator
allow	Allow
allright	Allright
allspice	Allspice
almanac	Almanac
almost	Almost
alone	Alone
along	Along
alphabet	Alphabet
already	Already
also	Also
altar	Altar
alter	Alter
alternate	Alternate
although	Although
aluminum	Aluminum
always	Always
amaze	Amaze
ambition	Ambition
ambulance	Ambulance
amen	Amen
amend_1	Amend - 1
amend_2	Amend - 2
america	America
amoeba	Amoeba
among	Among
amount	Amount
amuse	Amuse
amusement_park	Amusement Park
analysis	Analysis
analyst	Analyst
analyze	Analyze
anatomy	Anatomy
ancestor	Ancestor
anchor	Anchor - Ship
anchor_person_news	Anchor Person - News
ancient	Ancient
and	And
anesthesiology	Anesthesiology
angel	Angel
anger	Anger
angle	Angle
animal	Animal
animal_trainer	Animal Trainer
ankle	Ankle
anniversary	Anniversary
anniversary_gift	Anniversary Gift
anniversary_toast	Anniversary Toast
announce	Announce
annoy	Annoy
annual	Annual
anonymous	Anonymous
anorexia	Anorexia
another	Another
answer	Answer
answering_service	Answering Service
ant	Ant
antelope	Antelope
anthropology	Anthropology
anticipate_1	Anticipate - 1
anticipate_2	Anticipate - 2
anticipate_3	Anticipate - 3
antler	Antler
antonym	Antonym
anvil	Anvil
anxious	Anxious
any	Any
apart	Apart
apartment	Apartment
apathy	Apathy
ape	Ape
aphasic	Aphasic
apologize	Apologize
apostrophe	Apostrophe
apostrophe_punctuation	Punctuation - Apostrophe
apothecary	Apothecary
appear	Appear - Come Into Sight
appetite	Appetite
applaud	Applaud
applause	Applause
apple	Apple
application	Application
apply	Apply - 1
apply_2	Apply - 2
applying_pressure	Applying Pressure
appoint	Appoint
appointment_book	Appointment Book
approach	Approach - Come Near
appropriate	Appropriate
approve_1	Approve - 1
approve_2	Approve - 2
approximate	Approximate
approximately_equals	Approximately Equals
apricot	Apricot
april_1	April
april_showers	April Showers
apron	Apron
aquarium	Aquarium
aquatic_trainer	Aquatic Trainer
arch	Arch - Curved Shape
archeology	Archeology
archer	Archer
archery	Archery
architect	Architect
architecture	Architecture
area	Area - Region
argue	Argue
arise	Arise - Get Up
arithmetic	Arithmetic
arizona_1	Arizona - 1
arizona_2	Arizona - 2
arkansas	Arkansas
arm	Arm - Body
armadillo	Armadillo
armchair	Armchair
armoire	Armoire
armor	Armor
army	Army
around_1	Around - Circumnavigate
around_2	Around - Approximation
around_the_world	Around The World
arrest_1	Arrest - 1
arrest_2	Arrest - 2
arrive	Arrive
arrogant	Arrogant
arrow	Arrow
arrow_road_sign	Arrow - Road Sign
art	Art
art_critic	Art Critic
artery	Artery
arthritis	Arthritis
artichoke	Artichoke
article	Article - Prose
artist	Artist
as	As
ascend	Ascend
ash_tray	Ash Tray
ashamed	Ashamed
asia	Asia
asian	Asian - Race
ask	Ask
asleep	Asleep
asparagus_1	Asparagus
aspirin	Aspirin
assassin	Assassin
assemble	Assemble
assess	Assess
assign	Assign
assignment	Assignment
assist	Assist
associate	Associate - Verb
assorted	Assorted
assume	Assume
assure	Assure
astonish	Astonish
astronaut	Astronaut
astronomer	Astronomer
astronomy	Astronomy
at	At
ate	Ate
athlete	Athlete
atlanta	Atlanta
atlantic	Atlantic Ocean
atlas	Atlas
atm	ATM
atmosphere	Atmosphere
atom	Atom
attach	Attach
attack	Attack
attempt	Attempt
attend	Attend
attendance_award	Attendance Award
attention	Attention
attic	Attic
attire	Attire
attitude	Attitude
attorney	Attorney
attract_1	Attract - 1
attract_2	Attract - 2
auction	Auction
auctioneer	Auctioneer
audience	Audience
audio	Audio
audiology	Audiology
auditorium	Auditorium
august_1	August - Month
aunt	Aunt
australia_1	Australia - 1
australia_2	Australia - 2
author	Author
authority	Authority
autism	Autism
auto_body_worker	Autobody Worker
auto_mechanic	Auto Mechanic
auto_painter	Auto Painter
auto_rental	Auto Rental
autograph	Autograph
autoimmune_disease	Autoimmune Disease
automatic	Automatic
automobile	Automobile
autopsy	Autopsy
autumn	Autumn
avail	Avail
available	Available
avalanche	Avalanche
avenue	Avenue
average	Average - Common
avocado	Avocado
avoid	Avoid
awake	Awake
award	Award
aware	Aware
away	Away
awe_1	Awe - 1
awe_2	Awe - 2
awe_3	Awe - 3
awe_4	Awe - 4
awe_religious	Awe - Religious
awful	Awful
awkward	Awkward
axe	Axe
b	B
babble	Babble
baby	Baby
baby_bag	Baby Bag
baby_blanket	Baby Blanket
baby_bonnet	Baby Bonnet
baby_bootie	Baby Bootie
baby_bottle	Baby Bottle
baby_carriage	Baby Carriage
baby_carrier	Baby Carrier
baby_changing_table	Baby Changing Table
baby_clothes	Baby Clothes
baby_coat	Baby Coat
baby_cradle	Baby Cradle
baby_food_jar	Baby Food Jar
baby_food_warmer	Baby Food Warmer
baby_formula	Baby Formula
baby_lotion	Baby Lotion
baby_mittens	Baby Mittens
baby_naming	Baby Naming
baby_on_board	Baby On Board
baby_pacifier	Baby Pacifier
baby_powder	Baby Powder
baby_rattle	Baby Rattle
baby_scale	Baby Scale
baby_seat	Baby Seat
baby_shower	Baby Shower
baby_spoon	Baby Spoon
baby_stroller	Baby Stroller
baby_swing	Baby Swing
baby_toy	Baby Toy
baby_walker	Baby Walker
babysitter	Babysitter
bachelor	Bachelor
back	Back - Body
back_pain	Back Pain
back_scrubber	Back Scrubber
back_to_school	Back To School
background	Background
backhoe	Backhoe
backpack	Backpack
backpacker	Backpacker
bacon	Bacon
bacteria	Bacteria
bad	Bad
bad_habits	Bad Habits
badge	Badge
badminton	Badminton
bag	Bag - Flexible Container
bagel	Bagel
baggage_claim	Baggage Claim
bake	Bake
baker	Baker
bakery	Bakery
baking_pan	Baking Pan
balance	Balance - Equilibrium
balance_pole	Balance Pole
balancing	Balancing
balancing_act	Balancing Act
bald	Bald
ball	Ball - Round Object
ballet	Ballet
balloon	Balloon
ballot	Ballot
baloney	Baloney
baltimore	Baltimore
ban	Ban
banana	Banana
band_1	Band - Musical - 1
band_2	Band - Musical - 2
bandage	Bandage
bandaid	Band Aid
bandana	Bandana
bang	Bang - Vigorous Blow
banjo	Banjo
bank_1	Bank - 1
bank_2	Bank - 2
bank_teller	Bank Teller
banker	Banker
banner	Banner - Flag
banquet	Banquet
baptist	Baptist
baptize	Baptize
bar	Bar - Pole
bar_metal	Bar - Metal
bar_mitzvah	Bar Mitzvah
barbecue_grill	Barbecue Grill
barbed_wire	Barbed Wire
barbeque	Barbeque
barber	Barber
barber_chair	Barber Chair
barber_pole	Barber Pole
bare	Bare - Unadorned
bargain_shopper	Bargain Shopper
bark	Bark - Dog
barley	Barley
barn	Barn
barometer	Barometer
barrel	Barrel
barrette	Barrette
barricade	Barricade
barrier	Barrier
bartender	Bartender
base	Base - Lowest Part
baseball	Baseball - Round Ball
baseball_jersey	Baseball Jersey
baseball_player	Baseball Player
basement	Basement
bashful	Bashful
basic	Basic - Foundational
basil	Basil
basket	Basket
basket_wicker	Basket - Wicker
basketball	Basketball - Sport
basketball_player	Basketball Player
bat	Bat - Baseball
bat_animal	Bat - Animal
bat_mitzvah	Bat Mitzvah
batch	Batch
bath	Bath
bathrobe	Bathrobe
bathroom	Bathroom
bathroom_portable	Bathroom - Portable
bathtub	Bathtub
batter	Batter - Flour Mixture
battery	Battery - Electric
battle	Battle
bawl	Bawl
bay	Bay
beach	Beach - Noun
beach_furniture	Beach Furniture
beach_towel	Beach Towel
beach_vacation	Beach Vacation
beachwear	Beachwear
bead	Bead
beak	Beak
beaker	Beaker
beam	Beam - Ray
bean_1	Bean
bean_bag_chair	Bean Bag
bear	Bear - Animal
beard	Beard
beast	Beast
beat	Beat - Strike
beautician	Beautician
beauty	Beauty
beauty_consultant	Beauty Consultant
beauty_queen	Beauty Queen
beauty_salon	Beauty Salon
beauty_shop	Beauty Shop
beaver	Beaver
because	Because
become	Become
bed	Bed
bed_pan	Bed Pan
bedroom	Bedroom
bee	Bee
beef	Beef - Meat
beehive	Beehive
beekeeper	Beekeeper
been	Been
beep	Beep
beer	Beer
beet	Beet
beetle	Beetle
before	Before
beg	Beg
begin	Begin
behave	Behave
behind	Behind
beige	Beige
belief	Belief
believe	Believe
bell	Bell
bell_hop	Bell Hop
bellows_fireplace	Bellows - Fireplace
belly	Belly
belong	Belong
below	Below
belt	Belt - Clothing
belt_buckle	Belt Buckle
bench	Bench - Long Seat
bench_grinder	Bench Grinder
bend	Bend
beneath	Beneath
benefit	Benefit
berry	Berry
beside	Beside
best	Best
best_friend	Best Friend
best_man	Best Man
bet	Bet
bethlehem	Bethlehem
betray	Betray
better	Better
between	Between
beware	Beware
bewilder	Bewilder
beyond	Beyond
bib	Bib
bible	Bible
bibliography	Bibliography
bicycle	Bicycle
bicycle_crossing	Bicycle Crossing
bicycle_lane	Bicycle Lane
bicycle_route	Bicycle Route
bicycle_trail	Bicycle Trail
bid	Bid
big	Big
bike	Bike
biker	Bicyclist
biking	Biking
bikini	Bikini
billiards	Billiards
bind	Bind - Tie
binder	Binder - Notebook
bingo_game	Bingo Game
binoculars	Binoculars
biography	Biography
biology	Biology
bird	Bird
birdbath	Birdbath
birdcage	Birdcage
birdhouse	Birdhouse
birth	Birth
birth_announcement	Birth Announcement
birth_bouquet	Birth Bouquet
birth_certificate	Birth Certificate
birth_control_pills	Birth Control Pills
birth_process	Birth Process
birthday	Birthday
birthday_boy	Birthday Boy
birthday_cake	Birthday Cake
birthday_girl	Birthday Girl
biscuit	Biscuit
bishop	Bishop
bit_1	Bit - Very Small Portion
bite	Bite
bitter	Bitter
black	Black
blackjack	Blackjack
blade	Blade - Knife
blame	Blame
blank	Blank
blanket	Blanket
blanket_electric	Blanket - Electric
blaze	Blaze
bleach	Bleach
bleed	Bleed
bleeding	Bleeding
bleeding_wound	Bleeding Wound
blend	Blend
blender	Blender
bless	Bless
blew	Blew
blind	Blind
blind_spot	Blind Spot
blindfold	Blindfold
blink	Blink
blinking_light_ahead	Blinking Light Ahead
blister	Blister
blizzard	Blizzard
block	Block - Cube
blocked_traffic	Blocked Traffic
blocks_childrens	Block - Children's
blonde	Blonde
blood	Blood
blood_bank	Blood Bank
blood_donor	Blood Donor
blood_donor_registration	Blood Donor Registration
blood_pressure	Blood Pressure
blood_pressure_cuff	Blood Pressure Cuff
blood_pressure_meter	Blood Pressure Meter
bloom	Bloom
blouse	Blouse
blouse_sleeveless	Blouse - Sleeveless
blow	Blow - Air
blow_out_candle	Blow Out - Candle
blowdry	Blow Dry
blowout	Blowout - Tire
blowtorch	Blowtorch
blue	Blue
blueprint	Blueprint
blush	Blush - Turn Red
blush_applying	Blush Applying
blush_brush	Blush Brush
blush_makeup	Blush - Makeup
blushing_bride	Blushing Bride
board	Board - Plank
boarding_call	Boarding Call
boarding_pass	Boarding Pass
boarding_ticket	Boarding Ticket
boast	Boast
boat	Boat
boat_launch	Boat Launch
body	Body - Anatomy
body_bag_medical	Body Bag - Medical
bodyguard	Bodyguard
boil	Boil
boiling_point	Boiling Point
bold	Bold
bolt	Bolt - Secure
bomb	Bomb
bon_voyage	Bon Voyage
bone	Bone
bonfire	Bonfire
bonfire_party	Bonfire Party
bonnet	Bonnet
book	Book
book_accounting	Book - Accounting
book_algebra	Book - Algebra
book_anatomy	Book - Anatomy
book_art	Book - Art
book_art_history	Book - Art History
book_business	Book - Business
book_chemistry	Book - Chemistry
book_coloring	Book - Coloring
book_corner	Book Corner
book_english_grammar	Book - English Grammar
book_geography	Book - Geography
book_geometry	Book - Geometry
book_history	Book - History
book_law	Book - Law
book_literature	Book - Literature
book_math	Book - Math
book_medicine	Book - Medicine
book_music	Book - Music
book_photography	Book - Photography
book_report	Book Report
book_review	Book Review
book_science	Book - Science
book_shelf	Book Shelf
book_spelling	Book - Spelling
book_trigonometry	Book - Trigonometry
book_vender	Book Vender
book_worm	Book Worm
bookbag	Book Bag
bookkeeper	Bookkeeper
booklet	Booklet
books_paying_for	Books - Paying For
books_stack_of	Books - Stack Of
bookshelf	Bookshelf
boombox	Boombox
boomerang	Boomerang
boost	Boost
boots	Boots
boots_baby	Boots - Baby
boots_hiking	Boots - Hiking
boots_snow	Boots - Snow
border	Border
bored	Bored
born	Born
borrow	Borrow
boss	Boss
both	Both
bother	Bother
bottle	Bottle
bottle_manufacturing_company	Bottle Manufacturing Company
bottle_opener	Bottle Opener
bottom	Bottom
bought	Bought
boulevard	Boulevard
bounce	Bounce
bound	Bound - Leap
bouquet_of_flowers	Bouquet Of Flowers
bouquet_toss_wedding	Bouquet Toss - Wedding
boutineer	Boutineer
bow_1	Bow - Bow and Arrow
bow_2	Bow - Body Gesture
bow_on_package	Bow - On Package
bowel_movement	Bowel Movement
bowl	Bowl - Container
bowl_mixing	Bowl - Mixing
bowl_serving	Bowl - Serving
bowler	Bowler
bowling	Bowling
bowtie	Bow Tie
box_boy	Box Boy
boxing	Boxing
boxing_glove	Boxing Glove
boy	Boy
bra	Bra
bracelet	Bracelet
bracelet_charm	Bracelet - Charm
bracelet_id	Bracelet - ID
braces_dental	Braces - Dental
brag	Brag
braid	Braid
braille	Braille
brain	Brain
brain_damage	Brain Damage
brainstorm_ideas	Brainstorm - Ideas
brake	Brake
branch	Branch - Tree Limb
brand	Brand
brass	Brass
brat	Brat
brave	Brave
bread	Bread
bread_machine	Bread Machine
breadbox	Breadbox
break	Break
breakfast	Breakfast
breast	Breast
breathe	Breathe
breed	Breed
breeze	Breeze
bribe	Bribe
brick	Brick
brick_wall	Brick Wall
bricklayer	Bricklayer
bricks_laying	Bricks - Laying
bridal_gown	Bridal Gown
bridal_registry	Bridal Registry
bridal_shower	Bridal Shower
bride	Bride
bride_and_groom	Bride And Groom
bridegroom	Bridegroom
bridesmaids	Bridesmaids
bridge	Bridge
bridge_ahead	Bridge Ahead
bridge_closed	Bridge Closed
bridge_freezes	Bridge Freezes
bridge_out	Bridge Out
bridge_slippery_when_wet	Bridge Slippery When Wet
bridge_under_construction	Bridge Under Construction
brief	Brief - Short
bright	Bright
bright_lights	Bright Lights
brilliant	Brilliant
bring	Bring
britain	Britain
british	British
broach	Broach - Jewelry
broad	Broad
broccoli	Broccoli
brochure	Brochure
broil	Broil - 1
broiled	Broil - 2
broke	Broke - No Money
broken_arm	Broken Arm
broken_leg	Broken Leg
broken_nose	Broken Nose
broken_wrist	Broken Wrist
bronchitis	Bronchitis
brontosaurus	Brontosaurus
bronze	Bronze
brooch	Brooch
brook	Brook - Water
broom	Broom
broom_closet	Broom Closet
broth	Broth
brother	Brother
brought	Brought
brow	Brow
brown	Brown
bruise	Bruise
brush	Brush - Light Touch
brush_hair	Brush - Hair
brush_teeth	Brush - Teeth
bubble	Bubble
bucket	Bucket
buckle	Buckle
bud	Bud
buffalo	Buffalo
buffet	Buffet
bug	Bug
bug_spray	Bug Spray
build	Build
building_fund	Building Fund
building_materials	Building Materials
building_under_construction	Building Under Construction
bulb_flower	Bulb - Flower
bulb_light	Bulb - Light
bulimia	Bulimia
bull	Bull
bulldozer	Bulldozer
bulletin	Bulletin
bulletin_board	Bulletin Board
bullseye	Bull's Eye
bully	Bully
bump	Bump - Bulge
bump_ahead	Bump Ahead
bump_go_slow	Bump - Go Slow
bumper	Bumper
bumper_car	Bumper Car - Amusement Park
bun	Bun
bunch	Bunch
bundle	Bundle
bundled_up	Bundled Up
bunk_bed	Bunk Bed
bunny	Bunny
burden	Burden
burn	Burn
burn_center_medical	Burn Center - Medical
burner	Burner
burp_baby	Burp - Baby
bury_1	Bury - 1
bury_2	Bury - 2
bus	Bus
bus_driver	Bus Driver
bus_service	Bus Service
bus_station	Bus Station
bus_stop	Bus Stop
bus_stop_ahead	Bus Stop Ahead
bus_terminal	Bus Terminal
bus_trip	Bus Trip
buses_and_trucks_only	Buses And Trucks Only
buses_not_allowed	Buses Not Allowed
buses_ok	Buses OK
bush	Bush
business	Business
businessman	Businessman
businesswoman	Businesswoman
busy	Busy
but	But
butcher	Butcher
butcher_board	Butcher Board
butler	Butler
butter	Butter
butter_dish	Butter Dish
butterfly	Butterfly
button	Button
buy	Buy
buzz	Buzz
by	By
bye	Bye
c	C
c_clamp	C Clamp
cab_taxi	Cab - Taxi
cabbage	Cabbage
cabin	Cabin
cabin_area	Cabin Area
cabin_fever	Cabin Fever
cabinet	Cabinet
cable	Cable
cable_car	Cable Car
caboose	Caboose
cactus	Cactus
cadaver	Cadaver
cadaver_refrigeration	Cadaver Refrigeration
cafe	Cafe
cafeteria	Cafeteria
cafeteria_worker_1	Cafeteria Worker - 1
cafeteria_worker_2	Cafeteria Worker - 2
cage	Cage
cake	Cake
cake_and_ice_cream	Cake And Ice Cream
cake_decorate	Cake Decorate
cake_decorator	Cake Decorator
cake_server	Cake Server
calculate	Calculate
calculator	Calculator
calculus	Calculus
calendar	Calendar
calf	Calf - Baby Cow
california_1	California - 1
california_2	California - 2
caliper_dial	Caliper - Dial
caliper_precision	Caliper - Precision
call	Call
calligraphy_nib	Calligraphy Nib
calligraphy_pen	Calligraphy Pen
calling_in_sick	Calling In Sick
calm	Calm
calorie	Calorie
came	Came
camel	Camel
cameo	Cameo
camera	Camera
cameraman	Cameraman
camp	Camp
camp_and_trailer_site	Camp And Trailer Site
camper_person	Camper - Person
campers_only	Campers Only
campground	Campground
campground_parking	Campground Parking
campground_vehicles_only	Campground Vehicles Only
camping	Camping
can	Can - Is Able
can_opener	Can Opener - 1
can_opener_2	Can Opener - 2
canada	Canada
canal	Canal
cancel	Cancel
cancer	Cancer
candelabra	Candelabra
candle	Candle
candle_snuffer	Candle Snuffer
candy	Candy
candy_booth	Candy Booth
cane_walking	Cane - Walking
canine_officer	Canine Officer
canister	Canister
cannot	Cannot
canoe	Canoe
canoeing	Canoeing
canon	Cannon
cantalope	Cantalope
canyon	Canyon
cap	Cap - Top Of Container
cap_bus_driver	Cap - Bus Driver
cap_doorman	Cap - Doorman
cap_hat	Cap - Hat
cap_porter	Cap - Porter
cap_skycap	Cap - Skycap
capacity	Capacity
capital	Capital - Letter
capitol	Capitol
caplet_medicine	Caplet - Medicine
capsule_medicine	Capsule - Medicine
captain	Captain
caption	Caption
capture	Capture
car	Car - 1
car_2	Car - 2
car_hood	Car Hood
car_salesman	Car Salesman
car_seat	Car Seat - Child
caramel	Caramel
card_game	Card Game
card_shark	Card Shark
card_table	Card Table
cardiogram	Cardiogram
cardiology	Cardiology
cards	Cards
cards_ace	Cards - Ace
cards_clubs	Cards - Clubs
cards_diamonds	Cards - Diamonds
cards_hearts	Cards - Hearts
cards_jack	Cards - Jack
cards_king	Cards - King
cards_queen	Cards - Queen
cards_spades	Cards - Spades
care	Care
career	Career
careless	Careless
carnival	Carnival
carnival_barker	Carnival Barker
carnival_game	Carnival Game
carnival_midway	Carnival Midway
carnival_test_your_strength	Carnival Test Your Strength
carnival_winner	Carnival Winner
carol	Carol
carousel	Carousel
carousel_horse	Carousel Horse
carpenter	Carpenter
carpentry	Carpentry
carpet	Carpet
carpet_cleaner	Carpet Cleaner
carphone	Carphone
carpool	Carpool
carrot	Carrot
carry	Carry
cars_not_allowed	Cars Not Allowed
cars_ok	Cars OK
cars_only	Cars Only
cart	Cart
carton	Carton
cartoon	Cartoon
carve	Carve
case	Case - Carrying Container
cash	Cash
cashier	Cashier
cassarole	Cassarole
cassette	Cassette
cast_arm	Cast - Arm
castle	Castle
cat	Cat
catalogue	Catalogue
cataract	Cataract
catch	Catch
catch_bridal_bouquet	Catch - Bridal Bouquet
category	Category
caterer	Caterer
caterpillar	Caterpillar
catheterization_lab	Catheterization Lab
catholic	Catholic
catscan	Catscan
catsup	Catsup
cattle	Cattle
cattle_crossing	Cattle Crossing
caucasian	Caucasian - Race
cauliflower	Cauliflower
caulk	Caulk
caulking_gun	Caulking Gun
caulking_nozzle	Caulking Nozzle
cause	Cause
caution	Caution
cave	Cave
cavity_dental	Cavity - Dental
cease	Cease
ceiling	Ceiling
ceiling_fan	Ceiling Fan
celebrate	Celebrate
celery	Celery
cell	Cell - Biology - 1
cell_biology	Cell - Biology - 2
cell_phone	Cell Phone
cellar	Cellar
cement	Cement
cement_block	Cement Block
cement_mixer	Cement Mixer
cement_mixing	Cement Mixing
cement_pouring	Cement Pouring
cement_smoother	Cement Smoother
cement_truck	Cement Truck
cemetary	Cemetary
cent	Cent
center	Center
center_lane_closed	Center Lane Closed
center_lane_only	Center Lane Only
centigrade	Centigrade
centigram	Centigram
centimeter	Centimeter
centipede	Centipede
century	Century
cereal_1	Cereal - 1
cereal_2	Cereal - 2
ceremony	Ceremony
certain	Certain
certificate	Certificate
certificate_of_title	Certificate Of Title
certify	Certify
chain	Chain
chain_link	Chain Link
chains_required	Chains Required
chainsaw	Chainsaw
chair	Chair
chair_director	Chair - Director
chair_folding	Chair - Folding
chair_lawn	Chair - Lawn
chair_lawn_folding	Chair - Folding Lawn
chair_lounge	Chair _ Lounge
chair_loveseat	Chair - Loveseat
chair_recliner	Chair - Recliner
chair_rocking_1	Chair - Rocking - 1
chair_rocking_2	Chair - Rocking - 2
chair_stacking	Chair - Stacking
chair_wood	Chair - Wood
chalk	Chalk
chalk_and_eraser	Chalk And Eraser
chalkboard	Chalkboard
challenge	Challenge
champion	Champion
chance	Chance
chandelier	Chandelier
change	Change
change_lanes	Change Lanes
channel	Channel - Water
channel_locks	Channel Locks
chant	Chant
chanukkah	Chanukkah
chapel	Chapel
chapter	Chapter
character	Character
charades	Charades
charge	Charge - Credit
charity	Charity
charm	Charm
chart	Chart
chase	Chase
chat	Chat
chatter	Chatter
chauffer	Chauffer
cheap	Cheap
cheat_1	Cheat - 1
cheat_2	Cheat - 2
cheat_3	Cheat - 3
cheating_caught	Cheating - Caught
cheating_on_test	Cheating - On Test
check	Check - Verify
check_in	Check In
checkers	Checkers
checking_out_books	Checking Out Books
checkmark	Check Mark
checkup_medical	Checkup - Medical • Medical Checkup
cheek	Cheek
cheer	Cheer - Happy
cheer_team	Cheer - Team
cheerleader	Cheerleader
cheese	Cheese
cheese_grater	Cheese Grater
cheese_slicer	Cheese Slicer
cheetah	Cheetah
chef	Chef
chemist	Chemist
chemistry	Chemistry
chemistry_experiment	Chemistry Experiment
chemistry_flask	Chemistry Flask
chemistry_lab	Chemistry Lab
chemistry_test_tube	Chemistry Test Tube
cherry	Cherry
cherry_picker	Cherry Picker
chess	Chess
chess_player	Chess Player
chest	Chest - Anatomy
chest_of_drawers	Chest Of Drawers
chew	Chew
chewing_tobacco	Chewing Tobacco
chicago	Chicago
chick	Chick
chicken	Chicken - Animal
chicken_eating	Chicken - Eating
chicken_pox	Chicken Pox
chicken_scared	Chicken - Scared
chief	Chief - Boss
child	Child
childcare	Childcare
childcare_education	Childcare Education
children	Children
children_crossing	Children Crossing
children_no_running	Children - No Running
children_playing	Children Playing
children_present	Children Present
children_slow	Children - Slow
children_watch	Children - Watch
chili	Chili
chill	Chill
chime	Chime
chimney	Chimney
chimney_sweep	Chimney Sweep
chin	Chin
china_1	China - Country
china_hutch	China Hutch
chip	Chip
chipmunk	Chipmunk
chiropractic	Chiropractic
chiropractor	Chiropractor
chisel	Chisel
chisel_wood	Chisel - Wood
chocolate	Chocolate
choice	Choice
choir	Choir
choke	Choke
choking	Choking
choose	Choose
chop	Chop
chord	Chord
chore	Chore
chorus	Chorus
chose	Chose
chosen	Chosen
christ	Christ
christmas_1	Christmas - 1
christmas_2	Christmas - 2
chubby	Chubby
chuckle	Chuckle
church	Church
church_wedding	Church Wedding
cider	Cider
cigarette	Cigarette
cinnamon	Cinnamon
circle	Circle - Shape
circle_ahead	Circle Ahead
circuit	Circuit
circular_power_saw_blade	Circular Power Saw Blade
circumstance	Circumstance
circus	Circus
circus_big_top	Circus Big Top
circus_center_ring	Circus Center Ring
circus_ringmaster	Circus Ringmaster
circus_strong_man	Circus Strong Man
citizen	Citizen
city	City
civil	Civil
claim	Claim
clam	Clam
clamp	Clamp
clamp_bar	Clamp Bar
clap	Clap
clarinet	Clarinet
clash	Clash
class	Class - Group
class_ring	Class Ring
class_schedule	Class Schedule
classroom	Classroom
clause	Clause
claw	Claw
clay	Clay
clean	Clean
cleaners	Cleaners
cleaning_crew	Cleaning Crew
clear	Clear
cleaver_meat	Cleaver - Meat
clerk	Clerk
clever	Clever
client	Client
cliffs	Cliffs
climate	Climate
climax	Climax
climb	Climb
clinic	Clinic
clip	Clip
clipboard	Clipboard
clock	Clock
clock_grandfather	Clock - Grandfather
clock_mantel	Clock - Mantel
close_door	Close - Door
close_near	Close - Near
closed_caption_1	Closed Caption - 1
closed_caption_2	Closed Caption - 2
closet	Closet
closet_wardrobe	Closet - Wardrobe
cloth	Cloth
clothes	Clothes
clothes_boys	Clothes - Boy's
clothes_designer	Clothes - Designer
clothes_dryer	Clothes Dryer
clothes_fall	Clothes - Fall
clothes_girls	Clothes - Girl's
clothes_hanger	Clothes Hanger
clothes_irregular	Clothes - Irregular
clothes_mens	Clothes - Men's
clothes_petite	Clothes - Petite
clothes_plus_size	Clothes - Plus Size
clothes_spring	Clothes - Spring
clothes_summer	Clothes - Summer
clothes_winter	Clothes - Winter
clothes_womens	Clothes - Women's
clothesline	Clothesline
clothespin	Clothespin
clothier	Clothier
clouds	Clouds
cloudy	Cloudy
clover	Clover
clown	Clown
clown_face	Clown Face
clown_gun	Clown Gun
clown_pants	Clown Pants
clown_sailor	Clown Sailor
clown_shoe	Clown Shoes
clown_trick	Clown Trick
club	Club - Organization
clue	Clue
clumsy	Clumsy
cluster	Cluster
clutch	Clutch
co2_poisoning	CO2 Poisoning
coach	Coach - Person
coal	Coal
coarse	Coarse
coast	Coast
coat	Coat
coax	Coax
cobbler	Cobbler - Person - 1
cobbler_person	Cobbler - Person - 2
cocoa	Cocoa
coconut	Coconut
cocoon	Cocoon
code	Code
coffee	Coffee
coffee_creamer	Coffee Creamer
coffee_filter	Coffee Filter
coffee_grinder	Coffee Grinder
coffee_pot	Coffee Pot
cohesive	Cohesive
coin	Coin
coincide	Coincide
coke_1	Coke - 1
coke_2	Coke - 2
cold	Cold
cold_front	Cold Front
coldest	Coldest
coleslaw	Coleslaw
collapse	Collapse
collar	Collar - Shirt
collar_animal	Collar - Animal
colleague	Colleague
collect	Collect
college	College
college_application	College Application
college_library	College Library
college_student	College Student
collision	Collision
cologne	Cologne
colon_punctuation	Punctuation - Colon
colony	Colony
color	Color
colorado_1	Colorado - 1
colorado_2	Colorado - 2
coloring_book	Coloring Book
colt	Colt
column	Column
comb	Comb - Verb
comb_noun	Comb - Noun
combination_square	Combination Square
combine	Combine
come	Come
comfort	Comfort
comic	Comic
comma	Comma • Punctuation - Comma
command	Command
commandment	Commandment
commence	Commence
commerce	Commerce
commercial	Commercial
commission	Commission
commit	Commit
committee	Committee
common	Common
communicate	Communicate
communion	Communion
communist	Communist
community	Community
commute	Commute
compact	Compact - Compress
compact_makeup	Compact - Makeup
company	Company
compare	Compare
compass	Compass
compassion	Compassion
compel	Compel
compete	Compete
competent	Competent
complain	Complain
complete_1	Complete - 1
complete_2	Complete - 2
complex	Complex
complicate	Complicate
compliment	Compliment
compose	Compose
compound	Compound
comprehend	Comprehend
compromise	Compromise
compulsion	Compulsion
compute	Compute
computer	Computer
computer_artist	Computer Artist
computer_lab	Computer Lab
computer_operator	Computer Operator
computer_student	Computer Student
computer_technician	Computer Technician
con_	Con - Against
conceal	Conceal
concede	Concede
conceit	Conceit
concentrate	Concentrate - 1
concentration	Concentrate - 2
concept	Concept
concern	Concern
concessions	Concessions
concrete	Concrete
concussion	Concussion
condense	Condense
condition	Condition
condom	Condom
condominium	Condominium
conduct	Conduct - Behavior
conductor_musical	Conductor - Musical
cone	Cone
confederate	Confederate
confession_a	Confession - 1
confession_b	Confession - 2
confetti	Confetti
confident	Confident
confirm	Confirm
conflict	Conflict
confront	Confront
confuse	Confuse
congratulate	Congratulate
congratulations	Congratulations
congress	Congress
congressman	Congressman
conjunction	Conjunction
connect	Connect
connecticut	Connecticut
conquer	Conquer
conscience	Conscience
conscious	Conscious
consequences	Consequences
conserve	Conserve
consider	Consider
consistent	Consistent
console	Console - Verb
consonant	Consonant
constant	Constant
constellation	Constellation
constipate	Constipate
constipation	Constipation
constitute	Constitute
construct	Construct
construction	Construction
construction_accident	Construction Accident
construction_ahead	Construction Ahead
construction_end	Construction End
construction_equipment	Construction Equipment
construction_sign	Construction Sign
construction_site	Construction Site
construction_trailer	Construction Trailer
construction_vehicles	Construction Vehicles
construction_worker	Construction Worker
construction_zone	Construction Zone
consult	Consult
consultant	Consultant
consume	Consume
contact	Contact - Touch
contact_lens	Contact Lens
contagious	Contagious
contain	Contain
container	Container
content	Content
contest	Contest
continent	Continent
continue	Continue
contour	Contour
contract	Contract
contractor	Contractor
contrast	Contrast
contribute	Contribute
control	Control
controversy	Controversy
convene	Convene
convenient	Convenient
convention	Convention
converse	Converse - Conversation
convert	Convert
convince	Convince
cook	Cook - Verb
cookie	Cookie
cookie_cutter	Cookie Cutter
cookie_jar	Cookie Jar
cookie_sheet	Cookie Sheet
cooking_show_host	Cooking Show Host
cool	Cool
cooperate	Cooperate
copper	Copper
copy	Copy
coral	Coral
cord	Cord - String
corduroy	Corduroy
core	Core - Center
cork	Cork
corkscrew	Corkscrew
corn_a	Corn - 1
corn_b	Corn - 2
corn_dog	Corn Dog
corner	Corner
correct	Correct - Right
correlate	Correlate
correspond	Correspond - Match
corsage	Corsage
cosmetic	Cosmetic
cosmetic_surgery	Cosmetic Surgery
cost	Cost
costume	Costume
cotter_pin	Cotter Pin
cotton	Cotton
cotton_candy	Cotton Candy
cotton_swab	Cotton Swab
couch	Couch - Furniture
cougar	Cougar
cough	Cough
could	Could
council	Council
counsel	Counsel
count	Count
counter	Counter
country	Country
county	County
county_fair	County Fair
couple	Couple - Two
coupon	Coupon
courage	Courage
courier	Courier
course	Course - Educational
court	Court - Judicial
court_reporter	Court Reporter
courtesy	Courtesy
cousin_female	Cousin - Female
cousin_male	Cousin - Male
cove	Cove
coveralls	Coveralls
cow	Cow
coward	Coward
cozy	Cozy
cpr	CPR
crab	Crab
crack	Crack
cracker	Cracker
cracker_jack	Cracker Jack - Excellent
cradle	Cradle
craft	Craft - Art
crane	Crane - Machine
crane_operator	Crane Operator
crank	Crank
crash	Crash
crash_test_dummy	Crash Test Dummy
crate	Crate
crawl	Crawl
crayon	Crayon
craze	Craze
cream	Cream
create	Create
credential	Credential
credit	Credit - Recognition
creek	Creek
creep	Creep
crew	Crew
crib	Crib - Baby Bed
cricket	Cricket
cried	Cried
crime	Crime
cripple	Cripple
crisis	Crisis
criteria	Criteria
critic	Critic
crochet	Crochet
crockpot	Crockpot
crocodile	Crocodile
croissant	Croissant
crooked	Crooked
crop	Crop - Harvest
crop_top	Crop Top
cross	Cross - Religious
crossing_ahead	Crossing Ahead
crossing_guard	Crossing Guard
crossing_not_allowed	Crossing Not Allowed
crossroads	Crossroads
crosswalk	Crosswalk
crosswind	Crosswind
crossword_puzzle	Crossword Puzzle
crow	Crow - Bird
crowd	Crowd
crown	Crown
crucify	Crucify
cruel	Cruel
cruise_ship	Cruise Ship
crumb	Crumb
crumble	Crumble
crunch	Crunch
crusade	Crusade
crush	Crush
crust	Crust
crutch	Crutch
cry	Cry
crystal	Crystal
crystal_ball	Crystal Ball
cub_bear	Cub - Bear
cube	Cube
cuckoo_clock	Cuckoo Clock
cucumber	Cucumber
cuff	Cuff
cufflink	Cufflink
culture	Culture
cup	Cup - Small Container
cupboard	Cupboard
cupcake	Cupcake
cupid	Cupid
curb	Curb
cure	Cure
curious	Curious
curl	Curl
curling_iron	Curling Iron
current	Current - Electric
curse_1	Curse - 1
curse_2	Curse - 2
curtain	Curtain
curve	Curve
cushion	Cushion
custard	Custard
custody	Custody
custom	Custom
cut	Cut
cute	Cute
cutting_tool	Cutting Tool
cycle	Cycle
cyclone	Cyclone
cylinder	Cylinder
cymbal	Cymbal
d	D
dad	Dad
daffodil	Daffodil
daily	Daily
daisy	Daisy
dam	Dam
damage	Damage
damn	Damn
damp	Damp
dance	Dance
dandelion	Dandelion
dandy	Dandy
danger	Danger
dangerous_bend	Dangerous Bend
dark	Dark
darling	Darling
dart_game_piece	Dart - Game Piece
dartboard	Dartboard
darts_player	Darts Player
dash	Dash - Run
date_day	Date - Day
date_person	Date - Person
daughter	Daughter
dawn	Dawn
day	Day - 1
day_2	Day - 2
daylight_savings_time_1	Daylight Savings Time - 1
daylight_savings_time_2	Daylight Savings Time - 2
dead	Dead
dead_end	Dead End
deadbolt	Deadbolt
deaf_1	Deaf - 1
deaf_2	Deaf - 2
deal	Deal - Cards
deans_office	Dean's Office
dear	Dear
death	Death
deathbed	Deathbed
debate	Debate
debt	Debt
decade	Decade
deceive	Deceive
december	December
decent	Decent
decide	Decide
decimal	Decimal
decimeter	Decimeter
deck	Deck - Platform
declare	Declare
decode	Decode
decoder	Decoder
decorate	Decorate
decrease	Decrease
dedicate	Dedicate
deduce	Deduce
deep	Deep
deep_hole_driller	Deep Hole Driller
deer	Deer
deer_crossing	Deer Crossing
defeat	Defeat
defecation	Defecation
defend	Defend
defense	Defense
deficit	Deficit
define	Define
definite	Definite
deflate	Deflate
defy	Defy
degenerate	Degenerate
degree	Degree - Educational
delaware	Delaware
delay	Delay
delayed_flight	Delayed Flight
delegate	Delegate
delicate	Delicate
delicious	Delicious
delight	Delight
delinquent	Delinquent
deliver	Deliver
delivery_person	Delivery Person
demand	Demand
democrat	Democrat
demolish	Demolish
demolition_man	Demolition Man
demon	Demon
demonstrate	Demonstrate
demote	Demote
denmark_a	Denmark - 1
denmark_b	Denmark - 2
denominator	Denominator
dental_checkup	Checkup - Dental • Dental Checkup 
dental_floss	Dental Floss
dental_insurance	Dental Insurance
dental_pick	Dental Pick
dental_xray	Dental Xray
dentist	Dentist
dentistry	Dentistry
dentures	Dentures
deny	Deny
deodorant	Deodorant
depart	Depart
department	Department
depend	Depend
deplete	Deplete
deposit	Deposit
depreciate	Depreciate
depress	Depress - Demoralize
depression	Depression - Mood
depth	Depth
dermatology	Dermatology
describe	Describe
desert	Desert
deserve	Deserve
design	Design
designate	Designate
designer	Designer
desire	Desire
desk	Desk
desk_and_chair	Desk And Chair
desk_computer	Desk - Computer
desktop	Desktop
desperate	Desperate
despise	Despise
dessert	Dessert
destine	Destine
destroy	Destroy
destruct	Destruct
detail	Detail - Item or Point
detain	Detain
detect	Detect
detective	Detective
detention	Detention
detergent	Detergent
deteriorate	Deteriorate
determine	Determine
detour	Detour
detour_ahead	Detour Ahead
develop	Develop
deviate	Deviate
device	Device
devil	Devil
devise	Devise
devote	Devote
dew	Dew
diabetes	Diabetes
diagnose	Diagnose
diagnoses	Diagnoses
diagnosis	Diagnosis
diagonal	Diagonal
diagram	Diagram
dialect	Dialect
dialogue	Dialogue
diameter	Diameter
diamond	Diamond
diaper	Diaper
diaper_bag	Diaper Bag
diaper_pail	Diaper Pail
diaper_pin	Diaper Pin
diaper_rash	Diaper Rash
diaphragm	Diaphragm
diarrhea	Diarrhea
dice	Dice
dice_rolling	Dice Rolling
dictionary	Dictionary
did	Did
die	Die
diet	Diet
differ	Differ
different	Different
difficult	Difficult
dig	Dig
digest	Digest - Food
digit	Digit - Number
digital_clock	Clock - Digital
dim	Dim
dim_lights	Dim Lights
dime	Dime
diminish	Diminish
dimple	Dimple
dine	Dine
dining_room	Dining Room
dinner	Dinner
dinosaur	Dinosaur
dip	Dip - Dunk
dip_in_road	Dip - In Road
diploma	Diploma
diploma_receiving	Diploma - Receiving
dipper_ladle	Dipper - Ladle
direct	Direct - Straight to the Point
direction	Direction
direction_asking_for	Directions - Asking For
director	Director
dirt	Dirt
disability	Disability
disagree	Disagree
disappear	Disappear
disappoint	Disappoint
disc_jockey	Disc Jockey
discount	Discount
discourage	Discourage
discover	Discover
discriminate	Discriminate
discuss	Discuss
disease	Disease
disguise	Disguise
disgust	Disgust
dish	Dish
dish_rack	Dish Rack
dish_soap	Dish Soap
dishes_dirty	Dishes - Dirty
dishwasher	Dishwasher
dishwasher_soap	Dishwasher Soap
disk	Disk
dismiss	Dismiss
dispenser	Dispenser
display	Display
disposable_gloves	Gloves - Disposable
dispose	Dispose
disrespect_1	Disrespect - 1
disrespect_2	Disrespect - 2
dissect	Dissect
disseminate	Disseminate
dissolve	Dissolve
distant	Distant
distinguish	Distinguish
distort	Distort
distract	Distract
distribute	Distribute
district	District
disturb	Disturb
dive	Dive
diver	Diver
diverge	Diverge
divide	Divide
divided_highway	Divided Highway
divided_highway_ends	Divided Highway Ends
divine	Divine
diving	Diving
division	Division - Separation
division_math	Division - Math
divorce	Divorce
dizzy	Dizzy
dna	DNA
do	Do
do_not_block_entrance	Do Not Block Entrance
do_not_block_intersection	Do Not Block Intersection
do_not_drink_and_drive	Do Not Drink And Drive
do_not_enter	Do Not Enter
do_not_pass	Do Not Pass
do_not_stop_on_train_tracks	Do Not Stop On Train Tracks
do_not_turn_the_page	Do Not Turn The Page
do_not_walk	Do Not Walk
doa_dead_on_arrival_1	DOA - Dead On Arrival - 1
doa_dead_on_arrival_2	DOA - Dead On Arrival - 2
dock	Dock
doctor_1	Doctor - 1
doctor_2	Doctor - 2
doctor_bag	Doctor Bag
doctor_chart	Doctor Chart
doctor_housecall	Doctor Housecall
doctor_on_call	Doctor On Call
doctrine	Doctrine
dodge	Dodge
does_not_equal	Does Not Equal - Math
dog	Dog
dog_catcher	Dog Catcher
dog_dish	Dog Dish
dog_groomer	Dog Groomer
dog_trainer	Dog Trainer
dog_waterbowl	Dog Water Bowl
dogfood_dish	Dog Food Dish
doghouse	Doghouse
dogs_must_be_on_leash	Dogs Must Be On Leash
doll	Doll
dollar	Dollar
dolphin	Dolphin
dome_clock	Clock - Dome
dominate	Dominate
domino	Dominoes
donate_blood	Donate Blood
done	Done
donkey	Donkey
door	Door
door_knocker	Door Knocker
doorknob	Doorknob
doorman	Doorman
doormat	Doormat
dorm	Dorm
dot	Dot
double	Double
double_feature	Double Feature
doubt	Doubt
dough	Dough
doughnut	Doughnut
dove	Dove
down	Down
downgrade	Downgrade
downspout	Downspout
dozen	Dozen
drafting	Drafting
drafting_table	Drafting Table
draftsman	Draftsman
drag	Drag - Pull
dragon	Dragon
dragonfly	Dragonfly
drain_snake	Drain Snake
drama	Drama
draw	Draw - Art
drawer	Drawer
dream	Dream
dream_vacation	Dream Vacation
dress	Dress
dress_designer	Dress Designer
dress_jumper	Dress - Jumper
dress_party	Dress - Party
dressed_up	Dressed Up
dresser	Dresser
dressing_room	Dressing Room
dressing_room_mens	Dressing Room - Men's
dressing_room_womens	Dressing Room - Women's
drift	Drift
drill_bit	Drill Bit
drill_case	Drill Case
drill_electric	Drill - Electric
drill_manual	Drill - Manual
drill_pneumatic	Drill - Pneumatic
drill_press	Drill Press
drill_press_operator	Drill Press Operator
drilling_for_oil	Drilling For Oil
drink	Drink
drink_machine_stocker	Drink Machine Stocker
drip	Drip
drive	Drive
drive_car	Drive Car
drive_defensively	Drive Defensively
drive_safely	Drive Safely
drive_through	Drive Through
driver_license_facility	Driver License Facility
driveway_caution	Driveway - Caution
driveway_do_not_block	Driveway - Do Not Block
drizzle	Drizzle
drool	Drool
drop	Drop
drown	Drown
drug	Drug
drug_prevention	Drug Prevention
drug_user	Drug User
drum	Drum - Musical
drum_major	Drum Major
drunk	Drunk
dry	Dry
dry_cleaner	Dry Cleaner
dryer	Dryer
drywall_anchor	Drywall Anchor
duck	Duck
duck_crossing	Duck Crossing
duckling	Duckling
dull	Dull
dumb	Dumb - Stupid
dump	Dump
dump_area	Dump Area
dump_area_ahead	Dump Area Ahead
dump_truck	Dump Truck
duplicate	Duplicate
during	During
dusk	Dusk
dust	Dust
dust_cloud	Dust Cloud
dustpan	Dustpan
dutch	Dutch
duty	Duty
dvd_player	DVD Player
dwarf	Dwarf - Short Person
dynamite	Dynamite
e	E
each	Each
eager	Eager
eagle	Eagle
ear	Ear
ear_infection	Ear Infection
ear_mold	Ear Mold
ear_nose_and_throat	Ear Nose And Throat
ear_protection	Ear Protection
ear_syringe	Ear Syringe
earache	Earache
early	Early
earmuffs	Ear Muffs
earn	Earn
earnest	Earnest - Sincere
earphones	Earphones
earplugs	Earplugs
earring	Earring
earrings	Earrings
earrings_hoops	Earrings - Hoops
earth	Earth
earth_mover	Earth Mover
earthquake	Earthquake
ease	Ease
easel	Easel
east	East
easter	Easter
easy	Easy
eat	Eat
echo	Echo
eclipse_solar	Eclipse Solar
ecology	Ecology
economics	Economics
economy	Economy
edge	Edge
edit	Edit
editor	Editor
educate	Educate
eel	Eel
effect	Effect
effort	Effort
egg	Egg
eggplant	Eggplant
egypt	Egypt
eiffel_tower	Eiffel Tower
eight	Eight
eighteen	Eighteen
eighty	Eighty
either	Either
eject	Eject
ekg_1	EKG - 1
ekg_2	EKG - 2
elaborate	Elaborate - Add Detail
elastic	Elastic
elbow	Elbow
elder	Elder - Church
elect	Elect
electric	Electric
electrician	Electrician
electricity	Electricity
electroencephalography	Electroencephalography
electron	Electron
electronic_game	Electronic Game - 1
electronic_games	Electronic Game - 2
electrotherapy	Electrotherapy
elegant	Elegant
element	Element
elementary	Elementary
elephant	Elephant
elevate	Elevate
elevator	Elevator
eleven	Eleven
elf	Elf
eliminate	Eliminate
elk	Elk
elope	Elope
else	Else
embarrass	Embarrass
emblem	Emblem
embroider	Embroider
embryo	Embryo
emerge	Emerge
emergency_flashers	Emergency Flashers
emergency_form	Emergency Form
emergency_medical_service	Emergency Medical Service
emergency_sign	Emergency Sign
emergency_vehicle	Emergency Vehicle
emergency_vehicle_zone	Emergency Vehicle Zone
emergency_vehicles_only	Emergency Vehicles Only
emit	Emit
emotion	Emotion
emperor	Emperor
emphasis	Emphasis
empire	Empire
employ	Employ
empress	Empress
empty	Empty
encourage	Encourage
encyclopedia	Encyclopedia
end	End
end_of_road	End Of Road
endoscopy	Endoscopy
enemy	Enemy
energy	Energy
enforce	Enforce
engage	Engage
engagement	Engagement
engine	Engine
engineer	Engineer
england	England
english	English
english_literature	English Literature
engross	Engross
enjoy	Enjoy
enormous	Enormous
enough	Enough
enter	Enter
enter_through_gate	Enter Through Gate
entertain	Entertain
entertainment_center	Entertainment Center
enthuse	Enthuse
entire	Entire
entomologist	Entomologist
entrance	Entrance
envelope	Envelope - Mail
environment	Environment
envy	Envy
epidemic	Epidemic
epilepsy	Epilepsy
episcopal	Episcopal
equal	Equal
equals_math	Equals - Math
equate	Equate
equation	Equation
equator	Equator
equip	Equip
equipment	Equipment
equivalent	Equivalent
era	Era
erase	Erase
erect	Erect - Build
error	Error
escalate	Escalate
escalator	Escalator
escape	Escape
escort	Escort
eskimo	Eskimo
especially	Especially
essay	Essay
essence	Essence
establish	Establish
esteem	Esteem
estimate	Estimate
etch	Etch
eternal	Eternal
eternity	Eternity
europe	Europe
evacuate	Evacuate
evade	Evade
evaluate	Evaluate
evaporate	Evaporate
eve	Eve
even	Even - Level
evening_gown	Evening Gown
event	Event
ever	Ever
every	Every
every_morning	Every Morning
everybody	Everybody
everyone	Everyone
evident	Evident
evil	Evil
evolution	Evolution
evolve	Evolve
exact	Exact
exaggerate	Exaggerate
exam	Exam - Test
examination	Examination
examination_equipment	Examination Equipment
examination_table	Examination Table
example	Example
excavate	Excavate
excavation	Excavation
excavator	Excavator
exceed	Exceed
excel	Excel
except	Except
excess	Excess
excessive	Excessive
exchange	Exchange
excite	Excite
exclaim	Exclaim
exclamation_point_punctuation	Punctuation - Exclamation Point
exclude	Exclude
exclusive	Exclusive
excuse	Excuse
exercise	Exercise
exhaust	Exhaust
exhibit	Exhibit
exist	Exist
exit	Exit
expand	Expand
expect	Expect
expense	Expense
experience	Experience
experiment	Experiment
experimental_surgery	Experimental Surgery
expert	Expert
expire	Expire
explain	Explain
explode	Explode
explore	Explore
explosives	Explosives
export	Export
expose	Expose
express	Express
expressive	Expressive
expressway	Expressway
extend	Extend
extension	Extension
extension_cord	Extension Cord
exterminator	Exterminator
extinct	Extinct
extinguish	Extinguish
extra	Extra
extract	Extract
extreme	Extreme
eye	Eye
eye_chart	Eye Chart
eye_check	Eye Check
eye_dropper	Eye Dropper
eye_exam	Eye Exam
eye_exam_equipment	Eye Exam Equipment
eye_shadow	Eye Shadow
eye_shadow_applying	Eye Shadow Applying
eye_shadow_brush	Eye Shadow Brush
eyebrow	Eyebrow
eyedrops	Eyedrops
eyeglasses	Eyeglasses
eyelash	Eyelash
eyeliner_applying	Eyeliner - Applying
eyeliner_pencil	Eyeliner Pencil
eyewash	Eyewash
f	F
fable	Fable
fabric	Fabric
fabulous	Fabulous
face	Face
face_painting	Face Painting
facemask	Face Mask
facilitate	Facilitate
fact	Fact
factor	Factor
factory	Factory
factory_worker	Factory Worker
faculty	Faculty - School
fade	Fade
fahrenheit	Fahrenheit
fail	Fail
faint	Faint - Swoon
fair	Fair - Equitable
fairy	Fairy
faith	Faith
faith_healer	Faith Healer
fake	Fake
fall	Fall - Tumble
fall_leaves	Fall Leaves
fall_season	Fall Season
falling_rocks	Falling Rocks
false	False
fame	Fame
familiar	Familiar
family	Family
family_photo	Family Photo
family_practice_medical	Family Practice - Medical
family_vacation	Family Vacation
famous	Famous
fan	Fan - Agitate The Air
fancy	Fancy
fang	Fang
fantastic	Fantastic
fantasy	Fantasy
far	Far
farewell	Farewell
farm	Farm
farmer	Farmer
fascinate	Fascinate
fashion	Fashion
fashion_designer	Fashion Designer
fashion_trend	Fashion Trend
fast	Fast - Quick
fasten	Fasten
fasten_seat_belt	Fasten Seat Belt
fat	Fat
fatality_car_accident	Fatality - Car Accident
fate	Fate
father	Father
father_of_the_bride	Father Of The Bride
fatigue	Fatigue
faucet	Faucet
faucet_drip	Faucet Drip
faucet_sprayer	Faucet Sprayer
fault	Fault
favor	Favor
favorite	Favorite
fear	Fear
feast	Feast
feather	Feather
feature	Feature - Characteristic
february	February
federal	Federal
fee	Fee
feed	Feed
feedback	Feedback
feel	Feel
feeling_better	Feeling Better
feet	Feet
fell	Fell
fellow	Fellow
female	Female
feminine	Feminine
fence	Fence - Barrier
fence_iron	Fence - Iron
fence_picket	Fence - Picket
fencer	Fencer - Sport Person
fencing	Fencing - Sport
fender_bender	Fender Bender
ferris_wheel	Ferris Wheel
ferry	Ferry
fertile	Fertile
fertility_center_medical	Fertility Center Medical
festival	Festival
fetus	Fetus
fever	Fever
few	Few
fib	Fib
fiber	Fiber
fiction	Fiction
field	Field - Land
field_surveyor	Field Surveyor
field_trip	Field Trip
fierce	Fierce
fifteen	Fifteen
fifth_anniversary	Fifth Anniversary
fiftieth_anniversary	Fiftieth Anniversary
fifty	Fifty
fight	Fight
figure	Figure - Reckon
figure_out	Figure Out
figure_skater	Figure Skater
file_tool	File - Tool
fill	Fill
film	Film
film_developer	Film Developer
filth	Filth
final	Final
finance	Finance
financial_aid_form	Financial Aid Form
find	Find
fine	Fine - Physical Well Being
fine_ticket	Fine - Ticket
finger	Finger
finger_injury	Finger Injury
fingernail_scissors	Fingernail Scissors
finish	Finish - Complete
finland_a	Finland - 1
finland_b	Finland - 2
fire	Fire - Something Burning
fire_department	Fire Department
fire_detector	Fire Detector
fire_extinguisher	Fire Extinguisher
fire_hose	Fire Hose
fire_hydrant	Fire Hydrant
fire_station	Fire Station
firefighter_1	Firefighter - 1
firefighter_2	Firefighter - 2
fireplace	Fireplace
fireworks	Fireworks
firm	Firm - Solid
first	First
first_aid	First Aid
first_aid_for_eyes	First Aid - For Eyes
first_aid_kit	First Aid Kit
first_aid_supplies	First Aid Supplies
first_anniversary	First Anniversary
first_day_of_school	First Day Of School
fish	Fish
fish_farmer	Fish Farmer
fisherman	Fisherman
fishing	Fishing
fishing_pole	Fishing Pole
fishmonger	Fishmonger
fit	Fit - Conform To
fits_to_a_tee	Fits To A Tee
five	Five
five_hundred_feet	Five Hundred Feet
five-speed	Five-Speed
fix	Fix
flabbergast	Flabbergast
flag	Flag
flag_waver	Flag Waver
flagman_ahead	Flagman Ahead
flake	Flake
flame	Flame
flaming_hoop	Flaming Hoop
flap	Flap
flapjack	Flapjack
flare	Flare
flash	Flash
flashing_lights	Flashing Lights
flashlight	Flashlight
flask	Flask
flat	Flat - Level
flat_liner_medical	Flat Liner - Medical
flatter	Flatter
flavor	Flavor
fleas	Fleas
flee	Flee
flesh	Flesh
flew	Flew
flex	Flex
flight_attendant	Flight Attendant
flight_waiting_for	Flight - Waiting For
fling	Fling - Toss
flirt	Flirt
float	Float
flock	Flock - Of Birds
flood	Flood
floor	Floor
floor_plan	Floor Plan
floor_tile	Floor Tile
florida_1	Florida - 1
florida_2	Florida - 2
florist	Florist
floss	Floss
flour	Flour
flow	Flow
flower	Flower
flower_girl_wedding	Flower Girl - Wedding
flowerpot	Flowerpot
flu	Flu
fluid	Fluid
flunk	Flunk
flush	Flush
flutter	Flutter
fly	Fly - Verb
fly_bug	Fly - Bug
flyswatter	Flyswatter
focus	Focus
foe	Foe
fog	Fog
fold	Fold - Verb
folder	Folder
folder_with_pockets	Folder - With Pockets
folk	Folk
follow	Follow
fond	Fond
food	Food
food_inspector	Food Inspector
food_processor	Food Processor
food_service	Food Service
food_tray	Food Tray
food_warmer	Food Warmer
fool	Fool
foot	Foot - Body
foot_care	Foot Care
foot_injury	Foot Injury
foot_measurement	Foot - Measurement
football_a	Football - 1
football_b	Football - 2
football_field	Football Field
football_helmet	Football Helmet
football_player	Football Player
for	For - Reason
forbid	Forbid
force	Force
fore	Fore
foreign	Foreign
foreman	Foreman
forest	Forest
forest_ranger	Forest Ranger
forever	Forever
forget	Forget
forgive	Forgive
fork	Fork - Utinsel
fork_serving	Fork - Serving
forklift	Forklift
forklift_operator	Forklift Operator
form	Form - Make
former	Former
formula	Formula
fort	Fort
forth	Forth
fortieth_anniversary	Fortieth Anniversary
fortunate	Fortunate
fortune	Fortune
fortune_teller	Fortune Teller
fortuneteller	Fortuneteller
forty	Forty
forward	Forward
foster	Foster
found_a_loss	Found - A Loss
found_establish	Found - Establish
foundation_laying	Foundation Laying
fountain	Fountain
four	Four
four_way_intersection	Four-Way Intersection
four_way_stop	Four-Way Stop
fourteen	Fourteen
fouton	Fouton
fox	Fox
fraction	Fraction
fracture_bone	Fracture - Bone
fragile	Fragile
fragment	Fragment
fragrant	Fragrant
frame	Frame - Picture
france	France
frank	Frank - Blunt
frankfurter	Frankfurter
freak	Freak
freckle	Freckle
free	Free
freeway	Freeway
freeze	Freeze
freight	Freight
french_fry	French Fry
french_horn	French Horn
frequent	Frequent
fresh	Fresh
freshman_1	Freshman - 1
freshman_2	Freshman - 2
friday	Friday
friday_13th	Friday - The 13th
friend	Friend
fright	Fright
fringe	Fringe
frisbee	Frisbee
frisk	Frisk
frog	Frog
from	From
front	Front - Forward Side
frost	Frost
frown	Frown
frozen	Frozen
fruit	Fruit
frustrate	Frustrate
frying_pan	Frying Pan
frying_pan_electric	Frying Pan - Electric
fudgsicle	Fudgsicle
fuel	Fuel
full	Full
fun	Fun
function	Function
fundamental	Fundamental
funeral	Funeral
funeral_procession	Funeral Procession
funnel	Funnel
funny	Funny
fur_coat	Fur Coat
fur_lined_coat	Fur-lined Coat
furnace	Furnace
furnish	Furnish - Provide
furniture	Furniture
furniture_corner_piece	Furniture - Corner Piece
furniture_cylinder_stand	Furniture - Cylinder Stand
fury	Fury
fuse_box	Fuse Box
fuss	Fuss
future	Future
g	G
gain	Gain
galaxy	Galaxy
gallaudet	Gallaudet
gallery	Gallery
gallon	Gallon
gallop_horse	Gallop - Horse
gamble	Gamble
game	Game
game_chips	Game Chips
game_show_host	Game Show Host
gameroom	Gameroom
gang	Gang
garage	Garage
garbage	Garbage
garbage_disposal	Garbage Disposal
garden_fork	Garden Fork
garden_hose	Garden Hose
garden_spade	Garden Spade
gardener	Gardener
garlic	Garlic
garment_bag	Garment Bag
garter	Garter
garter_toss_wedding	Garter Toss - Wedding
gas	Gas - Vapor
gas_flame	Gas Flame
gas_station_attendant	Gas Station Attendant
gasmask	Gasmask
gasoline	Gasoline
gate	Gate
gather	Gather
gay	Gay - Happy
gay_homosexual	Gay - Homosexual
gaze	Gaze
gear	Gear
gears_car	Gears - Car
gecko	Gecko
geese	Geese
gem	Gem
gender	Gender
general	General - As Opposed to Specific
general_medicine	General Medicine
general_practice_medical	General Practice - Medical
generate	Generate
generous	Generous
genius	Genius
gentle	Gentle
gentleman	Gentleman
gentlemen	Gentlemen
genuine	Genuine
geographer	Geographer
geography	Geography
geologist	Geologist
geology	Geology
geometry	Geometry
geometry_problem	Geometry Problem
georgia	Georgia
gerbil	Gerbil
geriatrics	Geriatrics
germ	Germ
german	German
germany_a	Germany - 1
germany_b	Germany - 2
gesture	Gesture
get	Get - Obtain
ghost	Ghost
giant	Giant
gift	Gift
gift_bag	Gift Bag
gift_certificate	Gift Certificate
gifts	Gifts
gigantic	Gigantic
giggle	Giggle
gill	Gill
ginger	Ginger
giraffe	Giraffe
girl	Girl
give	Give
give_up	Give Up
glacier	Glacier
glad	Glad
glance	Glance
glass	Glass
glass_blower	Glass Blower
glass_repair	Glass Repair
glasses_eyeglasses	Glasses - Eyeglasses
glasses_reading	Glasses - Reading
glaze	Glaze
glide	Glide
glimpse	Glimpse
glisten	Glisten
globe	Globe
glory	Glory
gloves	Gloves
gloves_rubber	Gloves - Rubber
glow	Glow
glue	Glue
glue_gun	Glue Gun
go	Go
goal	Goal
goat	Goat
gobble	Gobble
goblet	Goblet
goblin	Goblin
god	God
goggles	Goggles
gold	Gold
golden_anniversary	Golden Anniversary
goldfish	Goldfish
golf	Golf
golf_bag	Golf Bag
golfer	Golfer
gondola	Gondola
good	Good
good_job	Good Job!
goose	Goose
gopher	Gopher
gorgeous	Gorgeous
gorilla_1	Gorilla - 1
gorilla_2	Gorilla - 2
gospel	Gospel
gossip	Gossip
got	Got - Obtained
gouger_tool	Gouger - Tool
govern	Govern
governor	Governor
gown	Gown
grab	Grab
grace	Grace - Elegance
grade	Grade - School
grade_a	Grade - A
grade_a_plus	Grade - A Plus
grade_b	Grade - B
grade_b_plus	Grade - B Plus
grade_c	Grade - C
grade_c_plus	Grade - C Plus
grade_d	Grade - D
grade_f	Grade - F
grade_in_road	Grade - In Road
grader_construction	Grader - Construction
gradual	Gradual
graduate_college	Graduate - College
graduate_high_school	Graduate - High School
graduate_kindergarten	Graduate - Kindergarten
graduate_person	Graduate - Person
graduate_verb	Graduate - Verb
graduated_cyclinder	Graduated Cyclinder
graduation	Graduation
graduation_cap	Graduation Cap
graduation_cap_and_gown	Graduation Cap And Gown
graduation_card	Graduation Card
graduation_gift	Graduation Gift
graduation_gown	Graduation Gown
graduation_party	Graduation Party
graduation_tassle	Graduation Tassle
graham	Graham
grain	Grain
gram	Gram
grammar	Grammar
grand	Grand - Large In Scope
granddaughter	Granddaughter
grandfather	Grandfather
grandfather_clock	Grandfather Clock
grandmother	Grandmother
grandparents	Grandparents
grandson	Grandson
grant	Grant - Give
grape	Grape
grapefruit	Grapefruit
graph	Graph
graphic_designer	Graphic Designer
grasp	Grasp - Hold
grass	Grass
grasshopper	Grasshopper
grate	Grate - Verb
grateful	Grateful
gratitude	Gratitude
grave	Grave - Burial Site
gravel	Gravel
gravel_pit	Gravel Pit
gravy	Gravy
gray	Gray
graze	Graze - Munch
grease	Grease
great	Great
greater_than_math	Greater Than - Math
greater_than_or_equal_to_math	Greater Than Or Equal To - Math
greece	Greece
greed	Greed
green	Green
green_pepper	Green Pepper
gremlin	Gremlin
grey	Grey
grief	Grief
grieve	Grieve
grill	Grill - Cook
grim	Grim
grin	Grin
grind	Grind
grip	Grip
gripe	Gripe
groan	Groan
grocer	Grocer
grocery_bag	Grocery Bag
grocery_cart	Grocery Cart
grocery_clerk	Grocery Clerk
groom	Groom
groomsmen	Groomsmen
gross	Gross - Repulsive
grouch	Grouch
ground_noun	Ground - Noun
ground_verb	Ground - Press And Grind
group	Group
grove	Grove
grow	Grow
growl	Growl
growth	Growth
grumble	Grumble
guarantee	Guarantee
guard	Guard - Defend
guess	Guess
guest	Guest
guest_list	Guest List
guide	Guide
guidedog_blind	Guidedog - Blind
guilt	Guilt
guitar	Guitar
gull	Gull
gulp	Gulp
gum	Gum - Anatomy
gun	Gun
gurney	Gurney
gutter	Gutter
guy	Guy
gym	Gym
gym_coach	Gym Coach
gymnastic	Gymnastic
gynecological_exam	Gynecological Exam
h	H
habilitate	Habilitate
habit	Habit
had	Had
hail	Hail - Falling Ice
hair	Hair
hair_accessory	Hair Accessory
hair_brushing	Hair Brushing
hair_clippers	Hair Clippers
hair_messed_up	Hair - Messed Up
hair_pick	Hair Pick
hair_stylist	Hair Stylist
hairbrush	Hairbrush
hairclip	Hair Clip
hairdryer_handheld	Hair Dryer - Handheld
hairdryer_salon	Hair Dryer - Salon
hairspray	Hair Spray
half	Half
hall	Hall
halloween	Halloween
hallucinate	Hallucinate
hallucinations	Hallucination
halo	Halo
halt	Halt
halter_top	Halter Top
ham	Ham - Meat
hamburger	Hamburger
hammer	Hammer
hammer_ball_peen	Hammer - Ball Peen
hammer_steel	Hammer - Steel
hammer_tack	Hammer - Tack
hammer_verb	Hammer - Verb
hammer_wooden	Hammer - Wooden
hammock	Hammock
hamper	Hamper - Laundry
hamster	Hamster
hand	Hand
hand_accident	Hand Accident
hand_lotion	Hand Lotion
hand_truck	Hand Truck
hand_washing	Hand Washing
handball	Handball
handicapped	Handicapped
handicapped_parking	Handicapped Parking
handle	Handle - Grip Appendage
handsome	Handsome
handyman	Handyman
hang	Hang
hangar	Hangar
hanger	Hanger
hankerchief	Hankerchief
hanukkah	Hanukkah
happen	Happen
happy	Happy
happy_anniversary	Happy Anniversary
happy_birthday	Happy Birthday
happy_couple	Happy Couple
happy_graduation	Happy Graduation
harbor	Harbor
hard	Hard
hard_left	Hard Left
hard_right	Hard Right
hardhat	Hard Hat
hardhat_area	Hard Hat Area
hardware	Hardware
hare	Hare
harm	Harm
harmonica	Harmonica
harmony	Harmony
harp	Harp - Musical
harsh	Harsh
harvest	Harvest
harvest_moon	Harvest Moon
has	Has
hassle	Hassle
hat	Hat
hat_chef	Hat - Chef
hat_cowboy	Hat - Cowboy
hat_jungle	Hat - Jungle
hat_paper	Hat - Paper
hat_police	Hat - Police
hat_rack	Hat - Rack
hat_rain	Hat - Rain
hat_sombrero	Hat - Sombrero
hat_sun	Hat - Sun
hat_top_hat	Hat - Top Hat
hat_visor	Hat - Visor
hatchet	Hatchet
hate	Hate
haul	Haul
haunt	Haunt
have	Have
hawaii_1	Hawaii - 1
hawaii_2	Hawaii - 2
hawk	Hawk
hay	Hay
hazardous_materials_worker	Hazardous Materials Worker
haze	Haze
he	He
head	Head - Body
headache	Headache
headlights_car	Headlights - Car
heal	Heal
health	Health
health_background	Health Background
health_clinic	Health Clinic
health_conscious	Health Conscious
health_insurance	Health Insurance
health_spa	Health Spa
healthcare_provider	Healthcare Provider
heap	Heap
hear	Hear
hearing	Hearing
hearing_aid	Hearing Aid
hearing_ear_dog	Hearing Ear Dog
hearing_impaired	Hearing Impaired
hearing_problem	Hearing Problem
heart	Heart
heart_monitor	Heart Monitor
heartbeat	Heartbeat
heat	Heat
heater	Heater
heaven	Heaven
heavy	Heavy
hebrew	Hebrew
heel	Heel - Foot
height	Height
height_limitation	Height Limitation
heirloom	Heirloom
helicopter	Helicopter
helium_tank	Helium Tank
hell	Hell
hello	Hello
helmet	Helmet
help	Help
hematology	Hematology
hen	Hen
her	Her
herd	Herd
here	Here
heredity	Heredity
hero	Hero
hesitate	Hesitate
hex_head_bolt	Hex Head Bolt
hex_head_nut	Hex Head Nut
hiccup	Hiccup
hide	Hide - Conceal
high	High
high_in_cholestorol	High In Cholestorol
high_in_fat	High In Fat
high_school	High School
highchair	Highchair
highlighter	Highlighter
highway	Highway
highway_county	Highway - County
highway_interstate	Highway - Interstate
hike	Hike - 1
hiking	Hike - 2
hill	Hill
him	Him
hippopotamus	Hippopotamus
hire	Hire
his	His
hispanic	Hispanic
history_1	History - 1
history_2	History - 2
hit	Hit - Strike
hit_and_run	Hit And Run
hit_the_books	Hit The Books
hitch	Hitch - Trailer
hitchhiker	Hitchhiker
hiv	HIV
hoarse	Hoarse
hobby_horse	Hobby Horse
hockey	Hockey
hockey_player	Hockey Player
hog	Hog - Pig
hold	Hold - Grasp
hole	Hole
hole_punch_single	Hole Punch - Single
hole_punch_three	Hole Punch - Three
holiday	Holiday
holland_a	Holland - 1
holland_b	Holland - 2
holler	Holler
hollow	Hollow
holster	Holster
holy	Holy
home	Home
homebuilder	Homebuilder
homesick	Homesick
homework	Homework
homework_doing	Homework - Doing
homonym	Homonym
homosexual	Homosexual
honest	Honest
honey	Honey
honeycomb	Honeycomb
honeymoon	Honeymoon - 4
honeymoon_1	Honeymoon - 1
honeymoon_2	Honeymoon - 2
honeymoon_3	Honeymoon - 3
honor	Honor
honor_student	Honor Student
hood	Hood - Over A Head
hoofprints_horse	Hoofprints - Horse
hook	Hook - 1
hook_2	Hook - 2
hook_lifting_bar	Hook Lifting Bar
hoop	Hoop
hop	Hop - Jump
hope	Hope
hopscotch	Hopscotch
horizon	Horizon
horn	Horn - Music
horn_animal	Horn - Animal
horror	Horror
horse	Horse
horse_and_rider	Horse And Rider
horse_crossing	Horse Crossing
horseback_riding	Horseback Riding
horseshoe	Horseshoe
horshoes_game	Horseshoes - Game
hose	Hose - Water
hospital	Hospital
hospital_bed	Hospital Bed
hospital_entrance	Hospital Entrance
hospital_exit	Hospital Exit
hospital_food	Hospital Food
hospital_gown	Hospital Gown
hospital_roommates	Hospital Roommates
hospitality	Hospitality
hospitalization	Hospitalization
hostage	Hostage
hostile	Hostile
hot	Hot
hot_water_bottle	Hot Water Bottle
hotdog	Hotdog
hotel	Hotel
hottest	Hottest
hour	Hour
house	House
house_painter	House Painter
housekeeper	Housekeeper
how	How
howl	Howl
hug	Hug
huge	Huge
huh	Huh
hula	Hula
human	Human
humble	Humble
humid	Humid
humidifier	Humidifier
humor	Humor
hundred	Hundred
hunger	Hunger
hungry	Hungry
hunt	Hunt
hurricane	Hurricane
hurry	Hurry
hurt	Hurt
husband	Husband
hush	Hush
hut	Hut
hybrid	Hybrid
hydrant	Hydrant
hydraulic_lift	Hydraulic Lift
hydroplane	Hydroplane
hydrotherapy	Hydrotherapy
hymn	Hymn
hyperdermic_needle	Hyperdermic Needle
hypnosis	Hypnosis
hypnotize	Hypnotize
hypocrite	Hypocrite
hypodermic_needle	Hypodermic Needle
hypothesis	Hypothesis
hysteric	Hysteric
hysterical	Hysterical
i	I
ice	Ice
ice_bucket	Ice Bucket
ice_cream	Ice Cream
ice_cream_maker	Ice Cream Maker
ice_cream_vendor	Ice Cream Vendor
ice_cube_tray	Ice Cube Tray
ice_pick	Ice Pick
ice_scraper	Ice Scraper
ice_skater	Ice Skater
icicle	Icicle
idaho	Idaho
idea	Idea
identify	Identify
idiom	Idiom
idiot	Idiot
idle	Idle
idol	Idol
if	If
igloo	Igloo
ignorance	Ignorance
ignorant	Ignorant
ignore	Ignore
ill	Ill
illinois	Illinois
illusion	Illusion
illustrate	Illustrate
image	Image
imagine	Imagine
imitate	Imitate
immaculate	Immaculate
immediate	Immediate
immense	Immense
immunize	Immunize
impair	Impair
imply	Imply
import	Import - Bring In
important	Important
impossible	Impossible
impress	Impress
imprint	Imprint
improve	Improve
in	In
incense	Incense
incentive	Incentive
inch	Inch
incident	Incident
incline	Incline
include	Include
increase	Increase
increased_markedly	Increased - Markedly
indeed	Indeed
indent	Indent
independent	Independent
india	India
indian	Indian
indiana_1	Indiana - 1
indiana_2	Indiana - 2
indicate	Indicate
individual	Individual
industry	Industry
infant	Infant
infant_car_seat	Infant Car Seat
infatuate	Infatuate
infect	Infect
inferior	Inferior
infest	Infest
infiltrate	Infiltrate
infinite	Infinite
infirmary	Infirmary
inflate	Inflate
influence	Influence
inform	Inform
information	Information
ingredient	Ingredient
inhabit	Inhabit
inhaler	Inhaler
inherit	Inherit
initial	Initial - Start
initiate	Initiate
inject	Inject
injure	Injure
injured	Injured
injury_face	Injury - Face
injury_nose	Injury - Nose
ink_bottle	Ink Bottle
innocent	Innocent
insect	Insect
insert	Insert
inside	Inside
insist	Insist
inspect	Inspect
inspire	Inspire
install	Install
instant	Instant
instead	Instead
instinct	Instinct
institute	Institute
instruct	Instruct
instructions	Instructions
instructor	Instructor
instrument	Instrument - General Device
instruments_medical	Instruments - Medical
insult	Insult
insurance	Insurance
insurance_salesman	Insurance Salesman
insure	Insure
integrate	Integrate
intellect	Intellect
intelligent	Intelligent
intend	Intend
intense	Intense
interest	Interest
interfere	Interfere
interior_decorator	Interior Decorator
intermediate	Intermediate
intern	Intern
international	International
interpret	Interpret
interrogate	Interrogate
interrupt	Interrupt
intersection	Intersection
interval	Interval
interview	Interview
intestines	Intestines
intimate	Intimate
into	Into
intramuscular	Intramuscular
intravenous_1	Intravenous - 1
intravenous_2	Intravenous - 2
intrigue	Intrigue
introduce	Introduce
intrude	Intrude
invade	Invade
invent	Invent
inventory_clerk	Inventory Clerk
invert	Invert
invest	Invest
investigate	Investigate
investment_counselor_1	Investment Counselor - 1
investment_counselor_2	Investment Counselor - 2
invisible	Invisible
invitation	Invitation
invite	Invite
involve	Involve
inward	Inward
iowa	Iowa
ira_account	IRA Account
irate	Irate
ireland	Ireland
irish	Irish
iron	Iron - Metal
iron_electric	Iron - Electric
iron_household	Iron - Verb
ironing_board	Ironing Board
irony	Irony
irrigate	Irrigate
irritate	Irritate
island	Island
isolate	Isolate
israel	Israel
issue	Issue
it	It
italy_a	Italy - 1
italy_b	Italy - 2
itch	Itch
item	Item
iud_contraception_1	IUD Contraception - 1
iud_contraception_2	IUD Contraception - 2
iv_stand_medical	IV Stand - Medical
j	J
jack_in_the_box	Jack-In-The-Box
jack_o_lantern	Jack-o-Lantern
jacket	Jacket
jacket_hooded	Jacket - Hooded
jacket_leather	Jacket - Leather
jacket_school	Jacket - School
jacket_smoking	Jacket - Smoking
jackhammer	Jackhammer
jail	Jail
jam	Jam - Bread Spread
janitor_1	Janitor - 1
janitor_2	Janitor - 2
janitor_cart	Janitor Cart
january	January
japan_a	Japan - 1
japan_b	Japan - 2
jar_container	Jar - Container
jaw	Jaw
jaywalking	Jaywalking
jealous	Jealous
jeans	Jeans
jeep	Jeep
jellyfish	Jellyfish
jester	Jester
jesus	Jesus
jet	Jet
jet_ski	Jet Ski
jew	Jew
jewel	Jewel
jeweler	Jeweler
jewelry	Jewelry
jewelry_box	Jewelry Box
jewelry_set	Jewelry Set
jewish	Jewish
jingle	Jingle
jockey	Jockey
jog	Jog
join	Join
joint	Joint
joke	Joke
journal	Journal
journalist	Journalist
journey	Journey
joy	Joy
judge_professional	Judge - Person
juggle	Juggle
juggler	Juggler
juice	Juice
july	July
jumble	Jumble
jump	Jump
junction	Junction
june	June
jungle	Jungle
junk	Junk
just	Just - Equitable
just_married	Just Married
justice	Justice
juvenile	Juvenile
k	K
kangaroo	Kangaroo
kansas	Kansas
karaoke	Karaoke
karate	Karate
kayaking	Kayaking
keep	Keep - Retain
keep_left	Keep Left
keep_right	Keep Right
keep_your_distance	Keep Your Distance
kentucky	Kentucky
kerchief	Kerchief
ketchup	Ketchup
key	Key - For A Lock
keyboard	Keyboard
keyhole	Keyhole
kick	Kick
kid	Kid - Child
kidnap	Kidnap
kill	Kill
kilogram	Kilogram
kiloliter	Kiloliter
kilometer	Kilometer
kind	Kind
kindergarten	Kindergarten
king	King
kiss	Kiss
kissing_booth	Kissing Booth
kitchen_a	Kitchen - 1
kitchen_b	Kitchen - 2
kite	Kite
kitten	Kitten
kleenex	Kleenex
kneel	Kneel
knife	Knife
knife_bread	Knife - Bread
knife_electric	Knife - Electric
knife_sharpener	Knife - Sharpener
knit	Knit
knitting_booties	Knitting Booties
knob	Knob
knock	Knock
knot	Knot
know	Know
korea	Korea
kosher	Kosher
l	L
lab_coat	Lab Coat
lab_project	Lab Project
lab_technician	Lab Technician
label	Label
labor	Labor
laboratory	Laboratory
lack	Lack
lactose_intolerant	Lactose Intolerant
ladder	Ladder
lady	Lady
ladybug	Ladybug
lake	Lake
lamb	Lamb
lamp	Lamp
lamp_ceiling	Lamp - Ceiling
lamp_desk	Lamp - Desk
lamp_floor	Lamp - Floor
lamp_table	Lamp - Table
lamp_wall	Lamp - Wall
land	Land - Ground
landscaper	Landscaper
lane	Lane - Narrow Track or Road
lane_highway	Lane - Highway
lane_lights	Lane Lights
lane_narrows	Lane Narrows
lanes_merge	Lanes Merge
language	Language
lantern	Lantern
laptop	Laptop
lard	Lard
large	Large
lash	Lash - Whip
last	Last - End
late	Late
late_arrival	Late Arrival
late_for_class	Late - For Class
later	Later
lathe	Lathe
latin	Latin
latitude	Latitude
laugh	Laugh
launch	Launch
launder	Launder
laundry_basket	Laundry Basket
laundry_service	Laundry Service
law	Law
law_enforcement	Law Enforcement
lawn	Lawn
lawnmower	Lawnmower
lawyer	Lawyer
lay	Lay - Put
layer	Layer
lazy	Lazy
lead_guide	Lead - Guide
lead_metal	Lead - Metal
leader	Leader
leaf	Leaf
leaf_blower	Leaf Blower
league	League
leak	Leak
lean	Lean - Tilt
leap	Leap
learn	Learn
leash	Leash
least	Least
leather	Leather
leave	Leave
lecture	Lecture
ledge	Ledge
ledger	Ledger
left_direction	Left - Direction
left_gone	Left - Gone
left_lane_exit_only	Left Lane - Exit Only
left_lane_must_turn	Left Lane Must Turn
left_turn	Left Turn
leg	Leg
leg_brace	Leg Brace
legal	Legal
legend	Legend
legislate	Legislate
leisure	Leisure
lemon	Lemon
lemonade	Lemonade
lend	Lend
length	Length
lens	Lens
leotard	Leotard
leprechaun	Leprechaun
lesbian	Lesbian
less	Less
less_than_math	Less Than - Math
lesson	Lesson
let	Let - Allow
letter	Letter
lettuce	Lettuce
level	Level - Even
level_measurer	Level - Measuring Tool
liability	Liability
liar	Liar
liberty	Liberty
librarian	Librarian
library	Library
license	License - Document
license_number	License Number
license_plate	License Plate
lick	Lick
lid	Lid
lie_fib	Lie - Fib
lie_recline	Lie - Recline
life	Life
lifeguard	Lifeguard
lift	Lift
lifting_improperly	Lifting - Improperly
lifting_properly	Lifting Properly
light	Light - Illumination
lighter_cigarette	Lighter - Cigarette
lightning	Lightning
lightning_storm	Lightning Storm
like	Like - Similar
limb	Limb - Arm
lime	Lime
limit	Limit
limited_sight_distance	Limited Sight Distance
limousine	Limousine
line	Line
linguistic	Linguistic
link	Link - Connection
lion	Lion
lion_tamer	Lion Tamer
lip	Lips
lipstick	Lipstick
lipstick_applying	Lipstick - Applying
liquid	Liquid
liquid_container	Liquid Container
liquid_medicine	Liquid Medicine • Medicine - Liquid
liquid_metal	Liquid Metal
liquor	Liquor
list	List - Itemization
listen	Listen
liter	Liter
literal	Literal
literate	Literate
literature	Literature
litter	Litter
little	Little
live	Live
liver	Liver
living_room	Living Room
lizard	Lizard
llama	Llama
load	Load - Fill
loader_construction	Loader - Construction
loading_zone	Loading Zone
loaf	Loaf - Bread
loan	Loan
loan_officer	Loan Officer
lobster	Lobster
local	Local
locate	Locate
lock	Lock
locker	Locker
locket	Locket
lodge	Lodge
lodging	Lodging
log	Log
logic	Logic
lollipop	Lollipop
london	London
lonesome	Lonesome
long	Long - More Than Average Length
longitude	Longitude
look	Look
loop	Loop
loose	Loose - Not Tight
loose_gravel	Loose Gravel
lord	Lord
lose	Lose
lost	Lost
lost_in_translation	Lost In Translation
lost_luggage	Lost Luggage
lost_ticket	Lost Ticket
lot	Lot - Abundance
lotion	Lotion
lotion_applying	Lotion - Applying
loud	Loud
louisiana	Louisiana
lounge	Lounge
louse	Louse
lousy	Lousy
love	Love
lovely	Lovely
low	Low
low_clearance	Low Clearance
luck	Luck
lucky	Lucky
luggage	Luggage
luggage_tag	Luggage Tag
luggage_weigh_in	Luggage Weigh In
lumber	Lumber
lumber_measuring	Lumber - Measuring
lumberjack	Lumberjack
lump	Lump
lunch	Lunch
lunch_box	Lunch Box
lunchbag	Lunch Bag
lung	Lung
lust	Lust
lutheran	Lutheran
luxury	Luxury
lyric	Lyric
m	M
macaroni	Macaroni
macdonalds	McDonald's
machine	Machine
machinery_operator	Machinery Operator
mad	Mad - Angry
magazine	Magazine - Periodical
magic	Magic
magician	Magician
magnet	Magnet
magnificent	Magnificent
magnify	Magnify
magnifying_glass	Magnifying Glass
maid_1	Maid - 1
maid_2	Maid - 2
maid_of_honor	Maid Of Honor
mail	Mail
mail_carrier	Mail Carrier
mailbox	Mailbox
mailman	Mailman
maitre_d	Maitre D
majesty	Majesty
major	Major - Principle Field Of Study
majorette	Majorette
make	Make
makeup	Makeup
makeup_applying	Makeup - Applying
makeup_kit	Makeup Kit
makeup_removal	Makeup - Removal
male	Male
mallet_rubber	Mallet - Rubber
mammal	Mammal
man	Man
manage	Manage
management_1	Management - 1
management_2	Management - 2
manager	Manager
mane	Mane
manicure	Manicure
mannequin	Mannequin
manner	Manner
mansion	Mansion
manta_ray	Manta Ray
mantel_clock	Clock - Mantel
manual	Manual
manufacture	Manufacture
manuscript	Manuscript
many	Many
map	Map
march_month	March - Month
march_verb	March - Verb
marching_band	Marching Band
mardi_gras	Mardi Gras
mardi_gras_mask	Mardi Gras Mask
margarine	Margarine
margin	Margin
marines	Marines
mark	Mark
marker	Marker
market	Market
maroon	Maroon
marriage	Marriage
marry	Marry
marshmallow	Marshmallow
marvel	Marvel
maryland	Maryland
mascara	Mascara
mascara_applying	Mascara - Applying
mascot	Mascot
mash	Mash
mask	Mask
mask_medical	Mask - Medical
masonry	Masonry
mass	Mass
massachusetts	Massachusetts
massage	Massage
massage_machine	Massage - Machine
masseuse	Masseuse
master	Master
mat	Mat
matador	Matador
match	Match - For Fire
mate	Mate
material	Material
math	Math
math_award	Math Award
math_symbol	Math Symbol
matinee	Matinee
matter	Matter - Makes A Difference
mature	Mature
matzoth	Matzoth
maximalfacial_surgery	Maxillofacial Surgery
maximum	Maximum
may_month	May - Month
may_permission	May - Permission
maybe	Maybe
mayor	Mayor
me	Me
meadow	Meadow
meal	Meal - Food
mean	Mean - Intend
mean_trait	Mean - Trait
measles	Measles
measure	Measure
measuring_device	Measuring Device
measuring_spoon	Measuring Spoon
meat	Meat
meat_grinder	Meat Grinder
meat_inspector	Meat Inspector
mechanic	Mechanic
medal	Medal
medallion	Medallion
media_consultant	Media Consultant
median_highway	Median - Highway
median_road	Median - Road
medic	Medic
medical_airlift	Medical Airlift
medical_alert	Medical Alert
medical_bag	Medical Bag
medical_care	Medical Care
medical_chart	Medical Chart
medical_file	Medical File
medical_insurance	Medical Insurance
medical_kit	Medical Kit
medical_records	Medical Records
medical_symbol	Medical Symbol
medical_team	Medical Team
medical_technician	Medical Technician
medical_trash	Medical Trash
medicine	Medicine
medicine_bottle	Medicine Bottle
medicine_cabinet	Medicine Cabinet
medicine_dropper	Medicine Dropper
medicine_taking	Medicine - Taking
medicine_tube	Medicine Tube
meditate	Meditate
medium	Medium - Average
medium_rare	Medium-Rare
meet	Meet
meeting_group	Meeting - Group
megaphone	Megaphone
melody	Melody
melon	Melon
melt	Melt
member	Member
memo	Memo
memorize	Memorize
memory	Memory
men	Men
men_at_work	Men At Work
mend	Mend
menorah	Menorah
menstruate	Menstruate
mental	Mental
mental_hygiene	Mental Hygiene
mention	Mention
menu	Menu - Food List
mercy	Mercy
merge	Merge - Join Together
merge_ahead	Merge Ahead
merge_left	Merge Left
merge_right	Merge Right
merge_traffic	Merge - Traffic
merry	Merry
mess	Mess
message	Message
met	Met
metal	Metal
metal_detector	Metal Detector
meteorologist	Meteorologist
meter	Meter - Measuring A Quantity
meter_measurement	Meter - Unit of Measure
metered_parking	Metered Parking
method	Method
methodist	Methodist
metronome	Metronome
mexican_1	Mexican - Race - 1
mexican_2	Mexican - Race - 2
mexican_3	Mexican - Race - 3
mexico	Mexico
mice	Mice
michigan	Michigan
microphone	Microphone
microscope	Microscope
microscope_slide	Microscope Slide
microwave	Microwave
mid	Mid
middle	Middle
midget	Midget
midnight	Midnight
midwife	Midwife
might	Might - Power
mild	Mild
mild_limitation	Limitation - Mild
mile	Mile
mile_marker	Mile Marker
military	Military
milk	Milk
milkman	Milkman
mill	Mill
millileter	Millileter
millimeter	Millimeter
million	Million
milwaukee	Milwaukee
mime_person	Mime - Person
mime_verb	Mime - Verb
mince	Mince
mind	Mind - Faculty Of Reason
mine	Mine
miner_prospector	Miner Prospector
miniature	Miniature
minimum	Minimum
minimum_speed_limit	Minimum Speed Limit
mining_cart	Mining Cart
mining_tools	Mining Tools
minister	Minister
minnesota	Minnesota
minor	Minor - Secondary Field Of Study
minor_injuries	Minor Injuries
minus	Minus
minute	Minute - Time
mirror	Mirror
mirror_tool	Mirror Tool
mischief	Mischief
miser	Miser
miss_class	Miss - Class
miss_girl	Miss - Girl
miss_wrong	Miss - Wrong
miss_you	Miss - You
missed_flight	Missed Flight
mission	Mission
mississippi	Mississippi
missouri	Missouri
mistake	Mistake
misunderstand	Misunderstand
mitt	Mitt - Sport
mitten	Mitten
mix	Mix - Verb
mixer	Mixer - Electric
mixture	Mixture
mmain	Main
mmaine	Maine
mmainstream	Mainstream
mmaintain	Maintain
mmaintenance_car	Maintenance - Car
moan	Moan
mobile	Mobile
model	Model - Demonstrate
model_clothes	Model - Person
model_ship_building	Model Ship Building
model_train	Model Train
moderate_limitation	Limitation - Moderate
moderate_middle	Moderate - Middle
moderate_negotiate	Moderate - Negotiate
modern	Modern
modify	Modify
molar	Molar
molasses	Molasses
mold	Mold - Form
molecule	Molecule
mom	Mom
moment	Moment
momentum	Momentum
monday	Monday
money	Money
money_clip	Money Clip
money_manager	Money Manager
monkey	Monkey
monotone	Monotone
monsoon	Monsoon
monster	Monster
montana	Montana
month	Month
monthly	Monthly
moon	Moon
moon_crescent	Moon - Crescent
moon_full	Moon - Full
moonlight	Moonlight
moose	Moose
mop	Mop
moral	Moral - Ethical
morale	Morale
more	More
morgue	Morgue
mormon	Mormon
morning	Morning
mortar_and_pestle	Mortar And Pestle
mortar_mix	Mortar Mix
mortgage_broker	Mortgage Broker
mosquito	Mosquito
most	Most
motel	Motel
mother	Mother
mother_of_the_bride	Mother Of The Bride
motivate	Motivate
motive	Motive
motor	Motor
motor_vehicle	Motor Vehicle
motorcycle	Motorcycle
motorcycle_policeman	Motorcycle Policeman
mound	Mound
mount	Mount
mountain	Mountain
mourn	Mourn
mouse	Mouse - Animal
mousetrap	Mousetrap
mouth	Mouth
mouthwash	Mouthwash
move	Move
mover	Mover
movie	Movie
movie_comedy	Movie - Comedy
movie_drive_in	Movie - Drive In
movie_drive_in_parking_space	Movie - Drive In Parking
movie_drive_in_speaker	Movie - Drive In Speaker
movie_dvd	Movie - DVD
movie_floor_lights	Movie - Floor Lights
movie_horror	Movie - Horror
movie_poster	Movie Poster
movie_premiere	Movie - Premiere
movie_preview	Movie - Preview
movie_projection_room	Movie - Projection Room
movie_reclining_seat	Movie - Reclining Seat
movie_romantic	Movie - Romantic
movie_science_fiction	Movie - Science Fiction
movie_sneak_preview	Movie - Sneak Preview
movie_stadium_seating	Movie - Stadium Seating
movie_star	Movie Star
movie_supporting_character	Movie - Supporting Character
movie_theater_number	Movie - Theater Number
movie_times	Movie - Times
movie_usher	Movie - Usher
movie_vhs_tape	Movie - VHS Tape
movie_watching	Movie Watching
moving_walkway	Moving Walkway
mow	Mow
mr	Mr.
mri_1	MRI - 1
mri_2	MRI - 2
mrs	Mrs.
much	Much
mud	Mud
muffin	Muffin
muffler	Muffler
mug	Mug
mug_rack	Mug Rack
mule	Mule
multiple	Multiple
multiplication_1	Multiplication - 1
multiplication_2	Multiplication - 2
multiply	Multiply
mumble	Mumble
mumps	Mumps
munch	Munch
murder	Murder
murmor_heart	Murmor - Heart
muscle	Muscle
museum	Museum
mushroom	Mushroom
music	Music
music_box	Music Box
music_stand	Music Stand
musician	Musician
must	Must
mustache	Mustache
mustard	Mustard
mute_adjective	Mute - Adjective
mutter	Mutter
mutual	Mutual
my	My
mystery	Mystery
myth	Myth
n	N
nachos	Nachos
nag	Nag
nail_apron	Nail Apron
nail_clippers	Nail Clippers
nail_cutter	Nail Cutter
nail_fingernail	Nail - Fingernail
nail_hardware	Nail - Hardware
nail_keg	Nail Keg
nail_polish	Nail Polish
nail_polish_applying	Nail Polish - Applying
nail_verb	Nail - Verb
naive	Naive
naked	Naked
name	Name
nanny	Nanny
nap	Nap
nap_mat	Nap Mat
napkin	Napkin
narrow	Narrow
narrow_bridge	Narrow Bridge
nasal	Nasal
nasty	Nasty
nation	Nation
national_guard	National Guard
native	Native
natural_childbirth	Natural Childbirth
nature	Nature
naughty	Naughty
nausea	Nausea
navy	Navy
near	Near
neat	Neat
nebraska	Nebraska
necessary	Necessary
neck	Neck
necklace	Necklace
necklace_charm	Necklace - Charm
necklace_cross	Necklace - Cross
necklace_pendant	Necklace - Pendant
necktie	Necktie
necktie_clip	Necktie Clip
nectar	Nectar
need	Need
needle	Needle - Sewing
needle_shot	Needle - Shot
negative	Negative
neglect	Neglect
negotiate	Negotiate
neighbor	Neighbor
neighborhood_1	Neighborhood - 1
neighborhood_2	Neighborhood - 2
neither	Neither
nephew	Nephew
nerd	Nerd
nerve	Nerve
nervous	Nervous
nest	Nest
neurology	Neurology
neurosurgery	Neurosurgery
neuter	Neuter
neutral	Neutral - Impartial
neutral_gear	Neutral - Gear
neutron	Neutron
nevada	Nevada
never	Never
new	New
new_hampshire	New Hampshire
new_jersey	New Jersey
new_mexico	New Mexico
new_orleans	New Orleans
new_york_1	New York - 1
new_york_2	New York - 2
newborn	Newborn
newlywed	Newlywed
news_team	News Team
newscaster	Newscaster
newspaper	Newspaper
newspaper_salesman	Newspaper Salesman
next	Next
next_exit	Next Exit
next_exit_left	Next Exit Left
next_exit_right	Next Exit Right
nibble	Nibble
nice	Nice
nickel	Nickel - Money
niece	Niece
night	Night
nightgown	Nightgown
nightmare	Nightmare
nine	Nine
nine_lives	Nine Lives
nineteen	Nineteen
ninety	Ninety
nip	Nip
no	No
no_bicycles	No Bicycles
no_cars	No Cars
no_data	No Data
no_dumping_allowed	No Dumping Allowed
no_entry	No Entry
no_exit	No Exit
no_food	No Food
no_left_turn	No Left Turn
no_littering	No Littering
no_motorcycles	No Motorcycles
no_parking	No Parking
no_passing	No Passing
no_pedestrians	No Pedestrians
no_right_turn	No Right Turn
no_shoulder	No Shoulder
no_standing	No Standing
no_stopping	No Stopping
no_tailgating	No Tailgating
no_trailers_allowed	No Trailers Allowed
no_trespassing	No Trespassing
no_trucks_allowed	No Trucks Allowed
no_turn_on_red	No Turn On Red
no_u_turn	No U Turn
noble	Noble
noise	Noise
nominate	Nominate
none	None
noodle	Noodle
noon	Noon
norm	Norm
normal	Normal
north	North
north_carolina	North Carolina
north_dakota	North Dakota
norway_a	Norway - 1
norway_b	Norway - 2
norway_c	Norway - 3
nose	Nose
nose_blow	Nose - Blow
nosebleed	Nosebleed
nostril	Nostril
not	Not
not_a_through_street	Not A Through Street
notch	Notch
note	Note - Memo
notebook	Notebook
notebook_paper	Notebook Paper
notepad	Notepad
nothing	Nothing
notification	Notification
notion	Notion
november	November
now	Now
nude	Nude
number	Number
numeral	Numeral
numerator	Numerator
nun	Nun
nurse	Nurse
nurse_dressing_room	Nurse - Dressing Room
nurse_hat	Nurse - Hat
nurse_homecare	Nurse - Homecare
nursery_baby	Nursery - Baby
nursing_baby	Nursing - Baby
nursing_home	Nursing Home
nut	Nut
nutrient	Nutrient
nutrition	Nutrition
o	O
oars	Oars
oath	Oath
obey	Obey
object_noun	Object - Noun
object_verb	Object - Verb
objection	Objection
objective	Objective
obligate	Obligate
observation_room	Observation Room
observe	Observe
obstacle	Obstacle
obstetrician	Obstetrician
obstetrics	Obstetrics
obstinate	Obstinate
obtain	Obtain
obvious	Obvious
occupation	Occupation
occupy	Occupy
occur	Occur
ocean	Ocean
october	October
octopus	Octopus
odd	Odd
odor	Odor
of	Of
off	Off
offer	Offer
office	Office
office_manager	Office Manager
office_mobile	Office Mobile
often	Often
ohio	Ohio
oil	Oil
oil_barrel	Oil Barrel
oil_derrick	Oil Derrick
ointment	Ointment
oklahoma_1	Oklahoma - 1
oklahoma_2	Oklahoma - 2
old	Old
olive	Olive
olympics	Olympics
omit	Omit
on	On
on_the_sick_list	On The Sick List
once	Once
oncology	Oncology
oncoming_traffic	Oncoming Traffic
one	One
one_billion	One Billion
one_fourth	One-fourth
one_half	One-half
one_hundred	One Hundred
one_hundred_feet	One Hundred Feet
one_hundred_thousand	One Hundred Thousand
one_million	One Million
one_thousand	One Thousand
one_way_street	One-Way Street
onion	Onion
onion_rings	Onion Rings
only	Only
onto	Onto
onward	Onward
opaque	Opaque
open	Open
open_a_gift	Open - Gift
opera	Opera
operate_machine	Operate - Machine
operate_surgery	Operate - Surgery
operating_room	Operating Room
operating_table	Operating Table
operation	Operation
operation_surgery	Operation - Surgery
opinion	Opinion
opossum	Opossum
opportune	Opportune
oppose	Oppose
opthalmologist	Opthalmologist
opthalmology	Opthalmology
optician	Optician
option	Option
optometrist	Optometrist
optometry	Optometry
or	Or - 1
or_2	Or - 2
oral	Oral
orally	Orally
orange	Orange - Fruit
orange_color	Orange - Color
orbit	Orbit
orchard	Orchard
orchestra	Orchestra
order_command	Order - Command
order_from_menu	Order - From Menu
orderly_medical	Orderly - Medical
ordinance	Ordinance
ordinary	Ordinary
ore	Ore
oregon	Oregon
organ	Organ - Musical
organ_body	Organ - Body
organize	Organize
orient	Orient
origin	Origin
orothopedics	Orthopedics
orthodontic	Orthodontic
ostrich	Ostrich
other	Other
ottoman	Ottoman
ouch	Ouch
ought	Ought
ounce	Ounce
our	Our
out	Out
out_of_order	Out Of Order
out_of_order_sign	Out Of Order Sign
out_to_lunch	Out To Lunch
outfit	Outfit
outhouse	Outhouse
outlet_cover	Outlet Cover
outlet_electric	Outlet - Electric
outline	Outline
ova	Ova
oval	Oval
oven	Oven
oven_mitt	Oven Mitt
over	Over - 1
over_2	Over - 2
overalls	Overalls
overalls_childs	Overalls - Child's
overcoat	Overcoat
overeating	Overeating
overhead_projector	Overhead Projector
overheating	Overheating
overpass	Overpass
overweight	Overweight
overwhelm	Overwhelm
owe	Owe
own	Own
ox	Ox
oxygen	Oxygen
p	P
p_m_1	PM - time 1
p_m_2	PM - time 2
pacifier	Pacifier
pack	Pack - Put In Container
package	Package
packing_for_college	Packing For College
pad	Pad - Soft Cushion
paddle_bottom	Paddle - Bottom
paddle_oar	Paddle - Oar
paddle_table_tennis	Paddle - Table Tennis
padlock	Padlock
page	Page - Book
pageant	Pageant
pail	Pail
pain	Pain
paint	Paint
paint_can	Paint Can
paint_palette	Paint Palette
paint_roller	Paint Roller
paint_sprayer	Paint Sprayer
paint_thinner	Paint Thinner
paint_tray	Paint Tray
paintbrush	Paintbrush
painter	Painter
pair	Pair
pajamas	Pajamas
pajamas_childrens	Pajamas - Children's
pal	Pal
palace	Palace
pale	Pale
pallet_construction	Pallet - Construction
pamphlet	Pamphlet
pancake	Pancake
panda	Panda
panel	Panel
panic	Panic
pansy	Pansy
panther	Panther
panties	Panties
pantry_food	Pantry - Food
pants	Pants
paper	Paper
paper_airplane	Paper Airplane
paper_clip	Paper Clip
paper_towel	Paper Towel
paperboy	Paperboy
parachute	Parachute
parade	Parade
paradise	Paradise
paradox	Paradox
paragraph	Paragraph
parakeet	Parakeet
paralegal	Paralegal
parallel	Parallel
parallel_parking	Parallel Parking
paralysis	Paralysis
paralyze	Paralyze
paramedic	Paramedic
paranoid	Paranoid
paraprofessional	Paraprofessional
parasite	Parasite
paratrooper	Paratrooper
pardon	Pardon
pare	Pare
parent	Parent
parent_teacher_meeting	Parent-Teacher Meeting
parentheses_punctuation	Punctuation - Parentheses
parenthesis	Parenthesis
parents	Parents
parents_to_be	Parents To Be
paris	Paris
park_and_rail	Park And Rail
park_and_ride	Park And Ride
park_car	Park - Car
park_ranger	Park Ranger
parking	Parking
parking_attendant	Parking Attendant
parking_brake	Parking Brake
parking_hours	Parking Hours
parking_lights	Parking Lights
parking_meter	Parking Meter
parking_restriction	Parking Restriction
parking_short_term	Parking - Short Term
parking_spot	Parking Spot
parliament	Parliament
parochial_school	Parochial School
parrot	Parrot - Bird
part	Part - Portion
participate	Participate
particle	Particle
particular	Particular
partner	Partner
party	Party
party_favors	Party Favors
party_flyer	Party Flyer
party_hat	Party Hat
party_planner_book	Party Planner - Book
party_planner_person	Party Planner - Person
pass	Pass - Go Around
pass_car	Pass - Car
pass_with_care	Pass With Care
passenger	Passenger
passing_by_in_hallway	Passing By In Hallway
passing_permitted	Passing Permitted
passing_zone	Passing Zone
passover	Passover
passport_1	Passport - 1
passport_2	Passport - 2
password	Password
paste	Paste
pastry	Pastry
pasture	Pasture
pat	Pat
patch	Patch
path	Path
pathology	Pathology
patient_characteristic	Patient - Characteristic
patient_medical	Patient - Medical
patio_furniture	Patio Furniture
patriot	Patriot
patriotic	Patriotic
patrol	Patrol
pattern	Pattern
pause	Pause
pave	Pave
pavement_narrows	Pavement Narrows
paw	Paw
pawnbroker	Pawnbroker
pawprint	Pawprint
pay	Pay
pay_late_fees	Pay Late Fees
pay_toll	Pay Toll
pea	Pea
peace	Peace
peach	Peach
peak	Peak
peanut	Peanut
peanut_butter	Peanut Butter
pear	Pear
pebble	Pebble
peck	Peck - Like A Bird
peculiar	Peculiar
peddle_bicycle	Peddle - Bicycle
peddle_sell	Peddle - Sell
pedestrian	Pedestrian
pedestrian_crossing	Pedestrian Crossing
pediatric_emergency	Pediatric Emergency
pediatrician	Pediatrician
pediatrics	Pediatrics
peek	Peek
peel	Peel
peer_pressure	Peer Pressure
pen	Pen - Writing
penalty	Penalty
pencil	Pencil
pencil_box	Pencil Box
pencil_colored	Pencil - Colored
pencil_cup	Pencil Cup
pencil_red	Pencil - Red
pendulum	Pendulum
penetrate	Penetrate
penis	Penis
pennant	Pennant
pennant_school	Pennant School
pennsylvania	Pennsylvania
penny	Penny
people	People
pepper	Pepper
peppermill_1	Peppermill - 1
peppermill_2	Peppermill - 2
per	Per
perceive	Perceive
percent	Percent
percentage	Percentage
perch	Perch
percolate	Percolate
perfect	Perfect
perform	Perform
perfume	Perfume
perfume_spraying	Perfume - Spraying
perfume_testing	Perfume - Testing
perhaps	Perhaps
perimeter	Perimeter
period_punctuation	Period - Punctuation
period_time	Period - Time
periscope	Periscope
perish	Perish
permanent	Permanent
permit	Permit - Allow
permit_driving	Permit - Driving
perpendicular	Perpendicular
perpetual	Perpetual
persecute	Persecute
persist	Persist
person	Person
person_marker	Person - Marker
personality	Personality
perspective	Perspective
perspire	Perspire
persuade	Persuade
pervert	Pervert
pest	Pest
pet	Pet
pet_bed	Pet Bed
pet_care	Pet Care
pet_carrier	Pet Carrier
pet_food_dish	Pet Food Dish
pet_toy	Pet Toy
pet_water_bowl	Pet Water Bowl
petfood	Pet Food
petri_dish	Petri Dish
petting_zoo	Petting Zoo
pharmacist	Pharmacist
pharmacology	Pharmacology
pharmacy	Pharmacy
philadelphia	Philadelphia
philosophy	Philosophy
phobia	Phobia
phone	Phone
phone_stand	Phone Stand
photo	Photo
photo_album	Photo Album
photograph	Photograph
photographer	Photographer
phrase	Phrase
physical	Physical
physical_education	Physical Education
physical_examination	Physical Examination
physical_fitness	Physical Fitness
physical_therapy	Physical Therapy
physics	Physics
piano	Piano
piano_mover	Piano Mover
piano_tuner	Piano Tuner
piccolo	Piccolo
pick	Pick - Choose
pick_construction	Pick - Construction
pickaxe	Pickaxe
pickle	Pickle
picnic	Picnic
picnic_area	Picnic Area
picnic_basket	Picnic Basket
picnic_table	Picnic Table
picture	Picture
picture_id	Picture ID
pie	Pie
pie_throwing	Pie Throwing
piece	Piece
pier	Pier
pierce	Pierce
pig	Pig
pile	Pile
pilgrim	Pilgrim
pill	Pill
pillow	Pillow
pillow_throw	Pillow - Throw
pillowcase	Pillowcase
pills_bottle_of	Pills - Bottle Of
pilot	Pilot
pimple	Pimple
pin	Pin - Verb
pin_cushion	Pin Cushion
pin_flower	Pin - Flower
pinafore	Pinafore
pinch	Pinch
pineapple	Pineapple
ping_pong	Ping Pong
pink	Pink
pinkeye	Pinkeye
pint	Pint
pioneer	Pioneer
pipe	Pipe - Tobacco - 1
pipe_tobacco	Pipe - Tobacco - 2
pipes_construction	Pipes - Construction
pirate	Pirate
pitch	Pitch - Toss
pitcher	Pitcher
pitchfork	Pitchfork
pittsburgh	Pittsburgh
pity	Pity
pixie	Pixie
pizza	Pizza
pizza_cutter	Pizza Cutter
pizza_delivery_person	Pizza Delivery Person
pizza_maker	Pizza Maker
place	Place - Location
plagiarize	Plagiarize
plague	Plague
plaid	Plaid
plain_land	Plain - Land
plain_ordinary	Plain - Ordinary
plan	Plan
plane	Plane - Airplane
planer_tool	Planer - Tool
planet	Planet
plant	Plant - Vegetation
plant_cell	Plant Cell
plant_entrance	Plant Entrance
planter	Planter
plaster	Plaster
plastic_explosives	Plastic Explosives
plate	Plate
plateau	Plateau
platter	Platter
platypus	Platypus
play_fun	Play - Fun
play_theater	Play - Theater
playground	Playground
please	Please
pledge	Pledge
pledge_of_allegiance	Pledge Of Allegiance
plenty	Plenty
pliers	Pliers
pliers_long_nosed	Pliers - Long Nosed
plow	Plow
plug	Plug
plum	Plum
plumb_line	Plumb Line
plunger	Plunger
plural	Plural
plus	Plus
plywood	Plywood
pneumonia	Pneumonia
pocket	Pocket
pocket_watch	Pocket Watch
pocketbook	Pocketbook
pocketknife	Pocketknife
podiatrist	Podiatrist
podiatry	Podiatry
podium	Podium
poem	Poem
poet	Poet
poetry	Poetry
poignant_1	Poignant - 1
poignant_2	Poignant - 2
poignant_3	Poignant - 3
point	Point
point_of_interest	Point Of Interest
pointer	Pointer
poison	Poison
poke	Poke
poland	Poland
polar_bear	Polar Bear
pole	Pole
poles_construction	Poles - Construction
police	Police
police_officer	Police Officer
police_station	Police Station
policeman	Policeman
policy	Policy
polish	Polish
polite	Polite
politic	Politic
political_science	Political Science
pollute	Pollute
polo	Polo
polo_player	Polo Player
poncho	Poncho
pond	Pond
ponder	Ponder
pony	Pony
pony_ride	Pony Ride
pool	Pool - Swimming
pool_party	Pool Party - Swimming
pool_player	Pool Player - Game
pool_table	Pool Table
pool_water	Pool - Water
pooper_scooper	Pooper Scooper
poor	Poor
pop	Pop - Soda
popcorn	Popcorn
popcorn_cart	Popcorn Cart
popcorn_salt	Popcorn Salt
popular	Popular
populate	Populate
porch_swing	Porch Swing
porcupine	Porcupine
pork	Pork
porpoise	Porpoise
port	Port - Ship Direction
portable	Portable
position	Position
positive	Positive
possible	Possible
possum	Possum
post	Post - Notice Or Sign
post_office	Post Office
postal_worker	Postal Worker
poster	Poster
postpone	Postpone
posture	Posture
pot	Pot - Container
potato	Potato
potato_masher	Potato Masher
potholder	Potholder
potty	Potty
pouch	Pouch - Sack Or Pocket
pouch_money	Pouch - Money
pound	Pound - Weight
pour	Pour
pout	Pout
powder	Powder
power	Power
power_generator	Power Generator
power_steering	Power Steering
power_surge_strip	Power Surge Strip
pox	Pox
practice	Practice
praise	Praise
pray	Pray
preach	Preach
preacher	Preacher
precinct	Precinct
precious	Precious
precipitation	Precipitation
precise	Precise
predicate	Predicate
predict	Predict
prefer	Prefer
prefix	Prefix
pregnant	Pregnant
prejudice	Prejudice
premier	Premier - Best
premolar	Premolar
prepare	Prepare
presbyterian	Presbyterian
preschool	Preschool
prescribe	Prescribe
prescription	Prescription
presence	Presence
present_gift	Present - Gift
preserve	Preserve
president	President
press	Press - Apply Pressure
pressure_cooker	Pressure Cooker
pretend	Pretend
pretty	Pretty
pretzel	Pretzel
prevent	Prevent
price_a	Price - 1
price_b	Price - 2
price_tag	Price Tag
pride	Pride
priest	Priest
primary	Primary - Best Or First
prime	Prime - Quality
prime_minister	Prime Minister
prince	Prince
princess	Princess
principal	Principal
principals_office	Principal's Office
principle	Principle
print	Print
printer_person	Printer - Person
prior	Prior
priority	Priority
prison	Prison
private	Private - Personal
private_eye	Private Eye
private_property	Private Property
prize	Prize - Gift Or Award
pro	Pro - Very Well Qualified
probable	Probable
problem	Problem
proceed	Proceed
process	Process
processing_a_request	Processing - A Request
proclaim	Proclaim
procrastinate	Procrastinate
produce	Produce - Make
produce_vendor	Produce Vendor
producer	Producer
production_sheet	Production Sheet
productivity	Productivity
profess	Profess
profession	Profession
professor	Professor
profile	Profile
profit	Profit
profound	Profound
program	Program
progress	Progress
prohibit	Prohibit
project	Project - Task
projector_movie	Projector - Movie
projector_screen	Projector - Screen
prologue	Prologue
prom_1	Prom - 1
prom_2	Prom - 2
promise	Promise
promote	Promote
pronounce	Pronounce
proof	Proof - Evidence
propaganda	Propaganda
proper	Proper
property	Property
prophecy	Prophecy
proportion	Proportion
propose_marriage	Propose - Marriage
prose	Prose
prospector	Prospector
prosthetics	Prosthetics
prostitute	Prostitute
protect	Protect
protestant	Protestant
proton	Proton
prove	Prove
proverb	Proverb
provide	Provide
proximal	Proximal
prune	Prune - Clip
psychedelic	Psychedelic
psychiatrist	Psychiatrist
psychiatry	Psychiatry
psychologist	Psychologist
psychology	Psychology
psychology_experiment	Psychology Experiment
public	Public
public_school	Public School
publicity	Publicity
publisher	Publisher
puddle	Puddle
puff	Puff - Short Gust Of Air
pull	Pull
pulley	Pulley
pulling_a_tooth	Pulling A Tooth
pulminary_physiology	Pulminary Physiology
pulp_truck	Pulp Truck
pulse_check	Pulse Check
pulse_heartbeat	Pulse - Heartbeat
pump	Pump - Verb
pump_bottle	Pump Bottle
pump_construction	Pump - Construction
pumpkin	Pumpkin
punch	Punch - Jab
punctuation	Punctuation
punish	Punish
pupil	Pupil - Eye
puppet	Puppet
puppeteer	Puppeteer
puppy	Puppy
purchase	Purchase
pure	Pure
purple	Purple
purpose	Purpose
purse	Purse
purse_change	Purse - Change
pursue	Pursue
push	Push
push_for_walk_signal	Push For Walk Signal
put	Put
putty_knife	Putty Knife
puzzle	Puzzle
puzzle_piece	Puzzle Piece
pylon	Pylon
q	Q
quake	Quake
quaker	Quaker
qualification	Qualification
qualify	Qualify
quantity	Quantity
quarantined	Quarantined
quarrel	Quarrel
quart	Quart
quarter	Quarter
queen	Queen
question	Question
question_mark_punctuation	Punctuation - Question Mark
quick	Quick
quiet	Quiet
quit	Quit
quiz	Quiz
quote	Quote
quotient	Quotient
r	R
rabbi	Rabbi
rabbit_a	Rabbit - 1
rabbit_b	Rabbit - 2
raccoon	Raccoon
race	Race - Competition
rack	Rack - Shelf
racket	Racket - Sport
radar_enforced	Radar Enforced
radio	Radio
radio_clock	Clock - Radio
radioactive	Radioactive
radiology	Radiology
radiotherapy	Radiotherapy
radish	Radish
radius	Radius
raft	Raft
rafting	Rafting
rag	Rag
rage	Rage
rail	Rail
railroad_crossing	Railroad Crossing
railroad_crossing_gate	Railroad Crossing - Gate
railroad_crossing_no_gate	Railroad Crossing - No Gate
railroad_signal	Railroad Signal
rain	Rain
rain_puddle	Rain Puddle
rain_shelter	Rain Shelter
rainbow	Rainbow
raincoat	Raincoat
raindrop	Raindrop
rainy_day	Rainy Day
rainy_weather	Rainy Weather
raise	Raise - Elevate
raise_your_hand	Raise Your Hand
raisin	Raisin
rake	Rake
ram	Ram - Animal
ramp	Ramp
ran	Ran
ranch	Ranch
range	Range - Scope
rapid	Rapid
rare	Rare
rash	Rash - Medical
rat	Rat
ratchet	Ratchet
ratchet_pneumatic	Ratchet - Pneumatic
rate	Rate - Speed
rather	Rather
rattle	Rattle
ray	Ray
razor	Razor - Manual
razor_blade	Razor Blade
razor_electric	Razor - Electric
reach	Reach - Verb
reaction_time	Reaction Time
read	Read
reading	Reading
reading_aloud	Reading Aloud
ready	Ready - 1
ready_2	Ready - 2
real	Real
real_estate_agent	Real Estate Agent
real_estate_salesperson	Real Estate Salesperson
realize	Realize
reap	Reap
rear	Rear - Behind
rear_view_mirror	Rear View Mirror - Car
reason	Reason
reassuring_a_patient	Reassuring A Patient
rebel	Rebel - Verb
receive	Receive
recent	Recent
receptionist	Receptionist
recess	Recess - Pause Or Break
recipe	Recipe
recipe_book	Recipe Book
recipe_card	Recipe Card
recliner	Recliner
recognize	Recognize
recommend	Recommend
record_noun	Record - Noun
record_verb	Record - Verb
recovery_room	Recovery Room
recreational_vehicle	Recreational Vehicle
recruit	Recruit - Solicit
recruiter	Recruiter
rectal_exam	Rectal Exam
rectally	Rectally
rectangle	Rectangle
recycling_bin	Recycling Bin
red	Red
red_pepper	Red Pepper
reduce	Reduce
reduce_speed	Reduce Speed
reduce_speed_ahead	Reduce Speed Ahead
reel	Reel - Fishing
refer	Refer
referee	Referee
reflect	Reflect
reflex_hammer	Hammer - Reflex • Reflex Hammer
refrigerate	Refrigerate
refrigerator	Refrigerator
refuse	Refuse - Decline
region	Region
register	Register
registration	Registration
regress	Regress
regret	Regret
regular	Regular
rehabilitate	Rehabilitate
rehabilitation	Rehabilitation
rehearse	Rehearse
reign	Reign
reindeer	Reindeer
reinforce	Reinforce
reject	Reject
relate	Relate
relative	Relative
relax	Relax
relay	Relay
release	Release
relieve	Relieve
religion	Religion
rely	Rely
remain	Remain
remedy	Remedy
remember	Remember
remind	Remind
reminisce	Reminisce
remote	Remote - Far
remove	Remove
rent	Rent
rental_car	Rental Car
repair	Repair
repairman	Repairman
repeat	Repeat
repel	Repel
replace	Replace
reply	Reply
report	Report
report_card	Report Card
report_oral	Report - Oral
reporter	Reporter
represent	Represent
representative	Representative
reputation	Reputation
repute	Repute
request	Request
require	Require
rescue	Rescue
research	Research - 1
research_2	Research - 2
research_paper	Research Paper
researcher	Researcher
resent	Resent
reserve	Reserve
reserve_parking	Reserve Parking
reside	Reside
resign	Resign
resist	Resist
resource	Resource
respect	Respect
respirator	Respirator
responsible	Responsible
rest	Rest
rest_area	Rest Area
rest_stop	Rest Stop
restaurant	Restaurant
restless	Restless
restrain	Restrain
restroom	Restroom
result	Result
resume_work_experience	Resume - Work Experience
resurrection	Resurrection
resuscitator	Resuscitator
retard	Retard
retire	Retire
retirement	Retirement
retreat	Retreat - Withdraw
retrospect	Retrospect
return	Return
reveal	Reveal
revenge	Revenge
reverse	Reverse
review	Review
revise	Revise
revolt	Revolt
revolve	Revolve
reward	Reward
rhinoceros	Rhinoceros
rhode_island	Rhode Island
rhyme	Rhyme
ribbon_first_place	Ribbon - First Place
ribbon_honorable_mention	Ribbon - Honorable Mention
ribbon_second_place	Ribbon - Second Place
ribbon_third_place	Ribbon - Third Place
rice	Rice
rich	Rich
rid	Rid
riddle	Riddle
ride	Ride
ridicule	Ridicule
rifle	Rifle
right_bend	Right Bend
right_correct	Right - Correct
right_direction	Right - Direction
right_lane_closed	Right Lane Closed
right_lane_exit_only	Right Lane - Exit Only
right_lane_must_turn	Right Lane Must Turn
right_turn	Right Turn
ring	Ring
ring_bearer_wedding	Ring Bearer - Wedding
ring_diamond	Ring - Diamond
ring_for_service	Ring For Service
riot	Riot
rip	Rip
rise	Rise
rival	Rival
river	River
riverboat	Riverboat
roach	Roach
road	Road
road_bends	Road Bends
road_block	Road Block
road_closed	Road Closed
road_curves	Road Curves
road_curves_left	Road Curves Left
road_curves_right	Road Curves Right
road_ends	Road Ends
road_enters_from_right	Road Enters From Right
road_narrows	Road Narrows
road_shoulder_work	Road Shoulder Work
road_shoulder_work_ahead	Road Shoulder Work Ahead
road_sign	Road Sign
road_splits	Road Splits
road_trip	Road Trip
road_worker	Road Worker
roadwork	Road Work
roam	Roam
roar	Roar
rob	Rob
robe	Robe
robin	Robin
rock	Rock
rock_paper_scissors_game	Rock Paper Scissors Game
rock_star	Rock Star
rocket	Rocket
rocket_ride	Rocket Ride
rocking_chair_1	Rocking Chair - 1
rocking_chair_2	Rocking Chair - 2
rocking_horse	Rocking Horse
rodent	Rodent
role	Role
roll	Roll - Tumble
roller_construction	Roller - Construction
rollercoaster	Rollercoaster
rolling_pin	Rolling Pin
rolodex	Rolodex
romance	Romance
romantic	Romantic
rome	Rome
roof	Roof
roof_shingles	Roof Shingles
roof_ventilator	Roof Ventilator
roofer	Roofer
roofing_felt	Roofing Felt
room	Room
room_service	Room Service
roost	Roost
rooster	Rooster
root	Root
rope	Rope
rose	Rose
rot	Rot
rotate	Rotate
rotation_medical_service	Rotation - Medical Service
rough	Rough
round	Round - Shape
roundabout	Roundabout
route	Route
router_tool	Router - Tool
routine	Routine
row	Row - Tier
rowboat	Rowboat
royal	Royal
rub	Rub
rubber	Rubber
rubber_chicken	Rubber Chicken
rubella	Rubella
rude	Rude
rug	Rug
ruin	Ruin
rule	Rule - Principle
ruler	Ruler - Measuring Tool
ruler_king	Ruler - King
rummage	Rummage
rumor	Rumor
run	Run
run_animal	Run - Animal
run_car_engine	Run - Car Engine
run_copies	Run - Copies
run_for_office	Run - For Office
run_nose	Run - Nose
run_to_store	Run - To Store
runny_nose	Runny Nose
rural_area	Rural Area
rush	Rush
rush_hour	Rush Hour
russia	Russia
s	S
sabbath	Sabbath
sack	Sack - Bag
sacred	Sacred
sad	Sad
saddle	Saddle
safari	Safari
safe	Safe - Free From Risk
safety_pin	Safety Pin
said	Said
sailboat	Sailboat
sailing	Sailing
sailor	Sailor
saint	Saint
salad	Salad
salad_bowl	Salad Bowl
salami	Salami
sale	Sale
sales_counter	Sales Counter
salesclerk	Salesclerk
salesperson	Salesperson
salt	Salt
saltbox	Salt Box
salute	Salute
same	Same
sample	Sample
san_francisco	San Francisco
sand	Sand
sand_block	Sand Block
sandal	Sandal
sandbox	Sandbox
sander	Sander
sander_belt	Sander - Belt
sander_electric	Sander - Electric
sanding_power	Sanding - Power
sandpaper	Sandpaper
sandwich	Sandwich
sang	Sang
sanitary	Sanitary
sank	Sank
santa_claus	Santa Claus
sarcasm	Sarcasm
sat	Sat
satellite	Satellite
satisfy	Satisfy
saturday	Saturday
sauce	Sauce
sausage	Sausage
save	Save
saved_by_the_bell	Saved By The Bell
savior	Savior
saw_band_saw	Saw - Band Saw
saw_circular_saw	Saw - Circular Saw
saw_jigsaw	Saw - Jigsaw
saw_miter_saw	Saw - Miter Saw
saw_table_saw	Saw - Table Saw
saw_tool	Saw - Tool
saw_viewed	Saw - Viewed
sawhorse	Sawhorse
say	Say
say_aah	Say Aah
scale	Scale - Weight Measure
scalpel	Scalpel
scare	Scare
scarecrow	Scarecrow
scarf	Scarf
scatter	Scatter
scenic	Scenic
sceptic_room	Sceptic Room
sceptor	Sceptor
schedule	Schedule
scheme	Scheme
schizophrenic	Schizophrenic
scholar	Scholar
school	School
school_bell	School Bell
school_bus	School Bus
school_bus_stop	School Bus Stop
school_bus_stop_sign	School Bus Stop Sign
school_crossing	School Crossing
school_crossing_ahead	School Crossing Ahead
school_day	School Day
school_homecoming	School Homecoming
school_is_out	School Is Out
school_lecture	School Lecture
school_newspaper	School Newspaper
school_nurse	School Nurse
school_play	School Play
school_registration	School Registration
school_supplies	School Supplies
school_supply_checklist	School Supply Checklist
school_team	School Team
school_vacation	School Vacation
school_walking_to	School - Walking To
school_zone_drug_free	School Zone - Drug Free
school_zone_end	School Zone - End
science	Science
science_experiment	Science Experiment
science_lab	Science Lab
science_project	Science Project
scientist	Scientist
scissors	Scissors
scissors_food	Scissors - Food
scold	Scold
scoop	Scoop
score	Score - Competition
scorpion	Scorpion
scot	Scot
scotland_a	Scotland - 1
scotland_b	Scotland - 2
scout	Scout
scramble	Scramble
scrape	Scrape
scraper	Scraper - Tool
scratch	Scratch
scream	Scream
screw	Screw - Verb
screw_allen_screw	Screw - Allen Screw
screw_eye_screw	Screw - Eye Screw
screw_flathead	Screw - Flathead
screw_hardware	Screw - Hardware
screw_phillips	Screw - Phillips
screw_sheet_metal	Screw - Sheet Metal
screw_threads	Screw Threads
screw_woodscrew	Screw - Wood Screw
screwdriver	Screwdriver
screwdriver_electric	Screwdriver - Electric
screwdriver_phillips	Screwdriver - Phillips
script	Script
scrub	Scrub
scuba_diver	Scuba Diver
sculpt	Sculpt
sea	Sea
seahorse	Seahorse
seal_animal	Seal - Animal
seal_envelope	Seal - Envelope
seamstress	Seamstress
search	Search
searchlight	Searchlight
seashell	Seashell
season	Season
season_time_of_year	Season - Time Of Year
seat	Seat
seatbelt	Seatbelt
seating_chart	Seating Chart
second_number	Second - Number
second_time	Second - Time
secret	Secret
secretary	Secretary
section	Section
secure	Secure
security_guard	Security Guard
see	See
seed	Seed - Noun
seeing_eye_dog	Seeing-Eye Dog
seek	Seek
seem	Seem
seen	Seen
seesaw	Seesaw
segment	Segment
seldom	Seldom
select	Select
self	Self
selfish	Selfish
sell	Sell
semester	Semester
semicolon_punctuation	Punctuation - semicolon
seminary	Seminary
senate	Senate
senator	Senator
send	Send
senior	Senior - Student
sense	Sense - Sensation
sensitive	Sensitive
sentence	Sentence
separate	Separate
september	September
sequence	Sequence
sequin	Sequin
series	Series
serious	Serious
serum_lab	Serum Lab
servant	Servant
serve	Serve
service_station	Service Station
set	Set - Put
settle	Settle
seven	Seven
seventeen	Seventeen
seventy	Seventy
several	Several
severe_limitation	Limitation - Severe
sew	Sew
sewer	Sewer
sewing_dummy	Sewing Dummy
sewing_machine	Sewing Machine
sex	Sex - Gender
shackles	Shackles
shade	Shade
shadow	Shadow
shake	Shake
shakespeare	Shakespeare
shall	Shall
shallow	Shallow
shame	Shame
shampoo	Shampoo
shape	Shape
share	Share
shark	Shark
sharp	Sharp
shave	Shave
shaving_brush	Shaving Brush
shaving_cream	Shaving Cream
shaving_kit	Shaving Kit
she	She
shears	Shears
sheep	Sheep
sheet	Sheet
shelf	Shelf
shelf_glass	Shelf - Glass
shelter	Shelter
shepherd	Shepherd
shh	Shh
shield	Shield
shift_gears	Shift Gears
shine	Shine
ship	Ship - Vessel
ship_captain	Ship Captain
shirt	Shirt
shirt_and_tie	Shirt And Tie
shirt_basketball_jersey	Shirt - Basketball Jersey
shirt_mens	Shirt - Men's
shirt_sleeveless	Shirt - Sleeveless
shirt_sport_jersey	Shirt - Sport Jersey
shirt_tee	Shirt - Tee
shirt_turtleneck	Shirt - Turtleneck
shirt_tuxedo	Shirt - Tuxedo
shiver	Shiver
shock	Shock
shoe	Shoe
shoe_horn	Shoe Horn
shoe_shiner	Shoe Shiner
shoelaces	Shoe Laces
shoemaker	Shoemaker
shoes_ballet	Shoes - Ballet
shoes_thongs	Shoes - Thongs
shoot	Shoot
shop	Shop
shopkeeper	Shopkeeper
shopping	Shopping
short	Short - Not Long
short_order_cook	Short Order Cook
shorts	Shorts
shot	Shot
shot_immunization	Shot - Immunization
shot_medical	Shot - Medical
should	Should
shoulder	Shoulder - Body
shoulder_road	Shoulder - Road
shout	Shout
shovel	Shovel
show	Show
shower_bath	Shower - Bath
showerhead	Showerhead
showers_light_rain	Showers - Light Rain
showgirl	Showgirl
shrimp	Shrimp
shrink	Shrink
shut	Shut
shy	Shy
sick	Sick
sickle	Sickle
side	Side
side_mirrors_car	Side Mirrors - Car
siding_house	Siding - House
sids	SIDS
sieve	Sieve
sift	Sift
sigh	Sigh
sight	Sight
sign	Sign - Indication
sign_maker	Sign Maker
sign_painter	Sign Painter
signal	Signal
signal_ahead	Signal Ahead
silent	Silent
silly	Silly
silver	Silver
silver_anniversary	Silver Anniversary
similar	Similar
simple	Simple
simultaneous	Simultaneous
sin	Sin
since	Since
sing	Sing
singer	Singer
single	Single
sink	Sink - Fall
sink_washing	Sink - For Washing
sip	Sip
sir	Sir
siren	Siren
sister	Sister
sit	Sit
site	Site
situate	Situate
six	Six
sixteen	Sixteen
sixties_party	Sixties Party
sixty	Sixty
size	Size
sizzling_hot	Sizzling Hot
skate	Skate
skateboard	Skateboard
skateboarding	Skateboarding
skeleton	Skeleton
skeptic	Skeptic
sketch	Sketch
skewer_food	Skewer - Food
skid_car	Skid - Car
skiis_snow	Ski - Snow
skiis_water	Ski - Water
skill	Skill
skin	Skin
skinny	Skinny
skip	Skip - Omit
skirt	Skirt
skirt_long	Skirt - Long
skirt_mini	Skirt - Mini
skull	Skull
skunk	Skunk
sky	Sky
sky_diver	Sky Diver
sky_diving	Sky Diving
skylight	Skylight
skyscraper	Skyscraper
slam_on_brakes	Slam On Brakes
slap	Slap
slave	Slave
sled	Sled
sleep	Sleep
sleeping_bag	Sleeping Bag
sleepwalking	Sleepwalking
sleet	Sleet
sleeve	Sleeve
sleigh	Sleigh
sleigh_ride	Sleigh Ride
slice	Slice
slide	Slide - Verb
slight	Slight - Small Amount
slim	Slim
slip	Slip - Skid
slip_clothing	Slip - Clothing
slip_fall	Slip - Fall
slipper	Slippers
slippery	Slippery
slippery_when_wet	Slippery When Wet
slope	Slope
slot_machine	Slot Machine
slow	Slow
slow_moving	Slow Moving
small	Small
smart	Smart
smell	Smell
smile	Smile
smog	Smog
smog_alert	Smog Alert
smoke	Smoking - Cigarette
smoker_person	Smoker - Person
smoking_cigar	Smoking - Cigar
smoking_pipe	Smoking - Pipe
smooth	Smooth
snail	Snail
snake	Snake
snake_charmer	Snake Charmer
snap	Snap - Fingers
snatch	Snatch
sneak	Sneak
sneakers	Sneakers
sneeze	Sneeze
sniff	Sniff
snip	Snip
snob	Snob
snore	Snore
snow	Snow
snow_blower	Snow Blower
snow_chains	Snow Chains
snow_cloud	Snow Cloud
snow_drift	Snow Drift
snow_shovel	Snow Shovel
snow_skier	Snow Skier
snowfall	Snowfall
snowflake	Snowflake
snowing	Snowing
snowman	Snowman
snowmobile_crossing	Snowmobile Crossing
snowstorm	Snowstorm
soap	Soap
soap_bar	Soap Bar
soap_bubbles	Soap Bubbles
soap_dispenser	Soap Dispenser
soccer	Soccer
soccer_player	Soccer Player
social	Social
socialwork	Social Work
society	Society
socket	Socket
socket_deep	Socket - Deep
socks	Socks
soda	Soda
sofa	Sofa
sofa_bed	Sofa Bed
soft	Soft
soft_road_shoulder	Soft Road Shoulder
software	Software
soil	Soil
solar	Solar
sold	Sold
solder	Solder
solder_gun	Solder Gun
soldering_iron	Soldering Iron
soldier	Soldier
sole	Sole - Only
solid	Solid
solution	Solution
solve	Solve
some	Some
somersault	Somersault
sometimes	Sometimes
son	Son
song	Song
soon	Soon
sophisticate	Sophisticate
sophomore	Sophomore
sore	Sore
sore_throat	Sore Throat
sorry	Sorry
sort	Sort - Organize
soul_a	Soul - 1
soul_b	Soul - 2
sound	Sound
soup	Soup
sour	Sour
source	Source
south	South
south_carolina	South Carolina
south_dakota	South Dakota
space	Space
space_heater	Space Heater
spahgetti	Spaghetti
spain	Spain
spank	Spank
spark	Spark
sparkle	Sparkle
spatula	Spatula
speak	Speak
spear	Spear
special	Special
specific	Specific
specimen_cup	Specimen Cup
specimen_sample	Specimen Sample
speech	Speech
speed	Speed
speed_bump	Speed Bump
speed_checked	Speed Checked
speed_limit	Speed Limit
speed_limit_20_mph	Speed Limit - 20 MPH
speed_limit_30_mph	Speed Limit - 30 MPH
speed_limit_50_mph	Speed Limit - 50 MPH
speed_limit_minimum	Speed Limit Minimum
speed_zone_ahead	Speed Zone Ahead
speed_zone_end	Speed Zone - End
spell	Spell
spelling	Spelling
spelling_award	Spelling Award
spelling_bee	Spelling Bee
spend	Spend
spice	Spice
spice_rack	Spice Rack
spider	Spider
spider_web	Spider Web
spike_driver	Spike Driver
spill	Spill
spine	Spine
spiral_binder	Spiral Binder
spirit	Spirit
spit	Spit - Expectorate
splash	Splash
splice	Splice
splint	Splint
splinter	Splinter
split	Split
spoil	Spoil
spoke	Spoke - Verb
sponge	Sponge
spook	Spook
spool	Spool
spoon	Spoon
spoon_draining	Spoon - Draining
spoon_serving	Spoon - Serving
spoon_wooden	Spoon - Wooden
sport	Sport
sportcoat	Sport Coat
sports_medicine	Sports Medicine
spot	Spot
spotlight	Spotlight
spots_on_animal	Spots - On Animal
sprain	Sprain
spray	Spray
spray_bottle	Spray Bottle
spray_can	Spray Can
spray_gun	Spray Gun
spread	Spread - Move Outward
spring_cleaning	Spring Cleaning
spring_fever	Spring Fever
spring_flowers	Spring Flowers
spring_hardware	Spring - Hardware
spring_season	Spring - Season
sprinkle	Sprinkle
spy	Spy
squad	Squad
square	Square
squash	Squash - Verb
squeeze	Squeeze
squid	Squid
squirm	Squirm
squirrel	Squirrel
stab	Stab
stack	Stack
stadium	Stadium
staff	Staff - Office
stage	Stage - Platform
stain	Stain
stair	Stair
stale	Stale
stalk	Stalk - Vegetation
stall	Stall - Delay
stall_animal	Stall - Animal
stamp	Stamp
stamp_collector	Stamp Collector
stand	Stand - Verb
standard	Standard - Basis For Comparison
staple	Staple - Paper Fastener
stapler	Stapler
star	Star - Celestial
stare	Stare
starfish	Starfish
start	Start
startle	Startle
starve	Starve
state	State - Noun
state_fair	State Fair
static_free_clothing	Static Free Clothing
station	Station
stationary	Stationary
stationery	Stationery
statistics	Statistics
statue	Statue
stay	Stay
stead	Stead
steady_lights_car	Steady Lights - Car
steak	Steak
steal	Steal
steam	Steam
steamroller	Steamroller
steamy_day	Steamy Day
steel	Steel
steel_girder	Steel Girder
steel_pouring	Steel Pouring
steelworker	Steelworker
steep	Steep - Sharp Inclination
stem	Stem
step	Step
step_brother	Step-brother
step_father	Step-father
step_mother	Step-mother
step_sister	Step-sister
step_stool	Step Stool
stereo	Stereo
sterilization_body_for_surgery	Sterilization - Body For Surgery
sterilization_female	Sterilization - Female
sterilization_male	Sterilization - Male
sterilization_surgical_tools	Sterilization - Surgical Tools
stethoscope	Stethoscope
still	Still - Continuing
stilts	Stilts
stimulus	Stimulus
sting	Sting
stingy	Stingy
stink	Stink
stir	Stir
stitch	Stitch
stitches	Stitches
stocking	Stocking
stole	Stole - Verb
stomach	Stomach
stomach_flu	Stomach Flu
stone	Stone
stood	Stood
stop	Stop
stop_ahead	Stop Ahead
stop_here_on_red	Stop Here On Red
stop_line_car	Stop Line - Car
stop_sign	Stop Sign
stopwatch	Stopwatch
storage_cubes	Storage Cubes
store	Store - Shop
stork_fable	Stork - Fable
storm	Storm
storm_door	Storm Door
storm_window	Storm Window
story	Story - Tale
stove	Stove
stove_electric	Stove - Electric
stove_gas	Stove - Gas
straddle	Straddle
straight	Straight
strange	Strange
straw	Straw
strawberry	Strawberry
stray	Stray
stream	Stream - Water
streamers	Streamers
street	Street
street_cleaner	Street Cleaner
street_closed	Street Closed
street_ends	Street Ends
street_sign	Street Sign
strength	Strength
strep_throat	Strep Throat
stress	Stress - Pressure
stretch	Stretch
stretcher	Stretcher
strict	Strict
strike	Strike - Protest
string	String
strip	Strip
stripe	Stripe
strive	Strive
stroke	Stroke
strong	Strong
structure	Structure
struggle	Struggle
stubborn	Stubborn
student	Student
student_of_the_month	Student Of The Month
study	Study
study_area	Study Area
study_hall	Study Hall
stuff	Stuff - General Items
stupid	Stupid
style	Style
subject	Subject - Topic
submarine	Submarine
subscribe	Subscribe
substance	Substance
substitute	Substitute
subtle	Subtle
subtract	Subtract
subtraction	Subtraction
subway	Subway
succeed	Succeed
success	Success
suck	Suck
sucker	Sucker
sucking_your_thumb	Sucking Your Thumb
sudden	Sudden
suffer	Suffer
suffix	Suffix
sugar	Sugar
suggest	Suggest
suicide	Suicide
suit	Suit - Clothing
suit_mens	Suit - Men's
suit_womens	Suit - Women's
sum	Sum
summer	Summer
summon	Summon
sun	Sun
sunbather	Sunbather
sunburn	Sunburn
sundae	Sundae
sunday	Sunday
sung	Sung
sunglasses	Sunglasses
sunk	Sunk
sunny_day	Sunny Day
sunrise	Sunrise
sunset	Sunset
sunshine	Sunshine
super	Super
superintendent	Superintendent
superman	Superman
superstition	Superstition
supervise	Supervise
supper	Supper
supplement	Supplement
supply	Supply
support	Support
suppose	Suppose
suppress	Suppress
sure	Sure - Certain
surface	Surface
surfboard	Surfboard
surfer	Surfer
surgeon	Surgeon
surgery	Surgery
surgical_table	Surgical Table
surprise	Surprise
surprise_party	Surprise Party
surrender	Surrender
surround	Surround
surveyor	Surveyor
survive	Survive
suspect	Suspect
suspend	Suspend
suspenders	Suspenders - 1
suspenders_2	Suspenders - 2
swallow	Swallow - Verb
swam	Swam
swamp	Swamp
sweat	Sweat
sweater	Sweater
swede	Swede
sweden_a	Sweden - 1
sweden_b	Sweden - 2
sweep	Sweep
sweet	Sweet
sweet_sixteen	Sweet Sixteen
sweetheart	Sweetheart
swell	Swell - Good
swift	Swift
swim	Swim
swim_instructor	Swim Instructor
swimsuit	Swimsuit
swing	Swing
swipe	Swipe
switch	Switch
swollen	Swollen
sword	Sword
symbol	Symbol
sympathy	Sympathy
symptom	Symptom
synagogue	Synagogue
synonym	Synonym
syringe	Syringe
syrup	Syrup
system	System
t	T
t_square	T Square
table	Table
table_and_chair	Table And Chair
table_and_chairs	Table And Chairs
table_coffee	Table - Coffee
table_decorative	Table - Decorative
table_dining_room	Table - Dining Room
table_folding	Table - Folding
table_glass	Table - Glass
table_place_setting	Table - Place Setting
table_saw	Table Saw
table_stacking	Table - Stacking
table_tennis	Table Tennis
table_umbrella	Table - Umbrella
table_umbrella_and_chairs	Table - Umbrella And Chairs
table_vanity	Table - Vanity
tablet_pill	Tablet - Pill
tablet_writing	Tablet - Writing
tackle	Tackle
taco	Taco
tail	Tail - Animal
tailgate_truck	Tailgate - Truck
tailgate_verb	Tailgate - Verb
tailor	Tailor
take	Take
tale	Tale
talent	Talent
talk	Talk
tall	Tall
tambourine	Tambourine
tame	Tame
tan	Tan
tank	Tank
tank_top	Tank Top
tanning_bed	Tanning Bed
tap	Tap - Verb
tape	Tape
tape_dispenser	Tape Dispenser
tape_measure	Tape Measure
tar	Tar
tarantula	Tarantula
tardy	Tardy
target	Target
tarpaper	Tar Paper
tart	Tart
task	Task
taste	Taste
tattoo_artist	Tattoo Artist
taught	Taught
tax	Tax
taxi	Taxi
taxi_driver	Taxi Driver
taxi_parking_only	Taxi Parking Only
taxi_stand	Taxi Stand
tea	Tea
tea_hot	Tea - Hot
tea_iced	Tea - Iced
teach	Teach
teacher	Teacher
teachers_day	Teacher's Day
team	Team
tear_cry	Tear - Cry
tear_rip	Tear - Rip
tease	Tease - Annoy
technical	Technical
technician	Technician
technology	Technology
teddybear	Teddy Bear
teen	Teen
teeter_totter	Teeter-Totter
teeth	Teeth
teeth_dental_cleaning	Teeth - Dental Cleaning
telegraph	Telegraph
telephone	Telephone
telephone_operator	Telephone Operator
telescope	Telescope
television	Television
tell	Tell
teller	Teller
temper	Temper
temperature	Temperature
temple	Temple
temporary	Temporary
tempt	Tempt
ten	Ten
ten_thousand	Ten Thousand
ten_times_as_much	Ten Times As Much
tend	Tend
tennant_parking_only	Tennant Parking Only
tennessee	Tennessee
tennis	Tennis
tennis_ball	Tennis Ball
tennis_player	Tennis Player
tent	Tent
tenth_anniversary	Tenth Anniversary
tepee	Tepee
term	Term
terrible	Terrible
terrific	Terrific
territory	Territory
terror	Terror
test	Test
test_computer_program	Test - Computer Program
test_taking	Test - Taking
test_tube	Test Tube
testify	Testify
tests_grading	Test - Grading
texas_1	Texas - 1
texas_2	Texas - 2
texture	Texture
thank	Thank
thanksgiving	Thanksgiving
that	That
thaw_out	Thaw Out
theater	Theater
their	Their
them	Them
theme	Theme
then	Then
theory	Theory
therapy	Therapy
there	There
therefore	Therefore
thermometer	Thermometer
thermometer_digital	Thermometer - Digital
thermometer_ear	Thermometer - Ear
thermometer_electric	Thermometer - Electric
thermos	Thermos
thermostat_house	Thermostat - House
these	These
they	They
thick	Thick
thief	Thief
thimble	Thimble
thin	Thin
thing	Thing
think	Think
third	Third
thirst	Thirst
thirteen	Thirteen
thirtieth_anniversary	Thirtieth Anniversary
thirty	Thirty
this	This
thorn	Thorn
thorough	Thorough
those	Those
though	Though
thought	Thought
thousand	Thousand
thread	Thread
threat	Threat
three	Three
three_ring_binder	Three Ring Binder
thrill	Thrill
throat	Throat
throb	Throb
throne	Throne
through	Through
through_traffic	Through Traffic
throw	Throw - Verb
thrust	Thrust
thumb	Thumb
thumbtack	Thumbtack
thunder	Thunder
thunderstorm	Thunderstorm
thursday	Thursday
ticket	Ticket - Entry Stub
ticket_booth	Ticket Booth
ticket_fine	Ticket - Fine
ticket_purchase	Ticket Purchase
ticket_taker	Ticket Taker
ticket_window	Ticket Window
tickle_chin	Tickle - Chin
tickle_side	Tickle - Side
tidal_wave	Tidal Wave
tide	Tide
tie	Tie - Bow
tiger	Tiger
tight	Tight
tightrope	Tightrope
tightrope_walker	Tightrope Walker
till_ground	Till - Ground
till_time	Till - Time
timber	Timber
time	Time
time_01_oclock	One O'clock
time_02_oclock	Two O'clock
time_03_oclock	Three O'clock
time_04_oclock	Four O'clock
time_05_oclock	Five O'clock
time_06_oclock	Six O'clock
time_07_oclock	Seven O'clock
time_08_oclock	Eight O'clock
time_09_oclock	Nine O'clock
time_10_oclock	Ten O'clock
time_11_oclock	Eleven O'clock
time_12_oclock	Twelve O'clock
time_clock_punching	Time Clock - Punching
time_fall_back	Time - Fall Back
time_is_up	Time Is Up
time_keeper_sports	Time Keeper Sports
time_out	Time Out
time_sheet	Time Sheet
time_spring_forward	Time - Spring Forward
time_table	Time Table
timid	Timid
tin_snips	Tin Snips
tiny	Tiny
tip	Tip - Endpoint
tiptoe	Tiptoe
tire	Tire
tire_chains	Tire Chains
tired	Tired
tissue_nasal	Tissue - Nasal
title	Title
tnt	TNT
to	To
toad	Toad
toast	Toast - Bread
toast_celebration	Toast - Celebration
toaster	Toaster
toaster_oven	Toaster Oven
tobacco	Tobacco
tobacco_products	Tobacco Products
toboggan	Toboggan
today	Today
toe_tag_morgue	Toe Tag - Morgue
together	Together
toil	Toil
toilet	Toilet
toilet_paper	Toilet Paper
toilet_paper_holder	Toilet Paper Holder
toilet_scrub_brush	Toilet Scrub Brush
toilet_seat	Toilet Seat
told	Told
tolerate	Tolerate
toll_road	Toll Road
tollgate	Tollgate
tomato	Tomato
tomb	Tomb
tomorrow	Tomorrow
tongs	Tongs
tongue	Tongue
tongue_depressor	Tongue Depressor
tonight	Tonight
tonsillectomy	Tonsillectomy
tonsils	Tonsils
too	Too - Overly Abundant
too_also	Too - Also
took	Took
tool_belt	Tool Belt
tool_bench	Tool Bench
tool_caddy	Tool Caddy
tool_cart	Tool Cart
tool_chest	Tool Chest
tool_rack	Tool Rack
toolbox	Toolbox
tooth	Tooth
toothache	Toothache
toothbrush	Toothbrush
toothbrush_electric	Toothbrush - Electric
toothbrush_holder	Toothbrush Holder
toothbrushing	Toothbrushing
toothpaste	Toothpaste
top	Top - Upper Part
top_hat	Top Hat
topic	Topic
torch	Torch
tore	Tore
tornado	Tornado
tortoise	Tortoise
torture	Torture
toss	Toss
total	Total
touch	Touch - Contacting
touching_emotion_1	Touching - Emotion - 1
touching_emotion_2	Touching - Emotion - 2
touching_emotion_3	Touching - Emotion - 3
tough	Tough
tourist	Tourist
tournament	Tournament
tow	Tow
tow_away_zone	Tow Away Zone
toward	Toward
towel	Towel
towel_hook	Towel Hook
tower	Tower
tower_clock	Tower Clock
town	Town
toy	Toy
trace	Trace - Drawing
traction_medical	Traction - Medical
tractor	Tractor
tractor_crossing	Tractor Crossing
trade	Trade - Swap
tradition	Tradition
traffic	Traffic
traffic_cone	Traffic Cone
traffic_control	Traffic Control
traffic_controller	Traffic Controller
traffic_light_ahead	Traffic Light Ahead
traffic_lights	Traffic Lights
tragedy	Tragedy
tragic	Tragic
trail	Trail - Path
trailer	Trailer
trailer_park	Trailer Park
trailer_parking	Trailer Parking
trailers_permitted	Trailers Permitted
train	Train
train_station	Train Station
training_class	Training Class
trait	Trait
traitor	Traitor
trample	Trample
trampoline	Trampoline
tranquil	Tranquil
transfer	Transfer
transform	Transform
translate	Translate
transparency	Transparency
transparent	Transparent
transport	Transport
trap	Trap
trash	Trash
trash_can_1	Trash Can - 1
trash_can_2	Trash Can - 2
trash_can_3	Trash Can - 3
trash_collector	Trash Collector
trashman	Trash Man
travel	Travel
travel_agent	Travel Agent
travel_brochure	Travel Brochure
travel_documents	Travel Documents
travel_guide_person	Travel Guide - Person
travel_poster	Travel Poster
tray	Tray
treasure	Treasure
treat	Treat - Interact With Another
tree	Tree
tree_frog	Tree Frog
tremendous	Tremendous
triangle	Triangle - Shape
triangle_musical	Triangle - Musical
triangle_tool	Triangle - Tool
tribe	Tribe
tribute	Tribute
trick	Trick - Deceive
trick_animal	Trick - Animal
trick_or_treat	Trick Or Treat
tricycle	Tricycle
trillion	Trillion
trim	Trim - Clip
trip_journey	Trip - Journey
triple	Triple
triplets_babies	Triplets - Babies
triumph	Triumph
trivet	Trivet
trolley_car	Trolley Car
trombone	Trombone
troop	Troop
trophy	Trophy
trot	Trot
trouble	Trouble
trousers	Trousers
trowel	Trowel
truck_crossing	Truck Crossing
truck_driver	Truck Driver
truck_entrance	Truck Entrance
truck_rental	Truck Rental
truck_vehicle	Truck - Vehicle
trucks_do_not_enter	Trucks - Do Not Enter
trucks_not_allowed	Trucks Not Allowed
true	True
trumpet	Trumpet
trunk	Trunk - Storage
trust	Trust
try	Try
try_outs	Try Outs
trying_to_fit_in	Trying To Fit In
tshirt	T-shirt
tube	Tube
tuberculosis_test	Tuberculosis Test
tuesday	Tuesday
tug	Tug - Pull
tug_of_war	Tug Of War
tulip	Tulip
tumble	Tumble
tumor	Tumor
tuna	Tuna
tune	Tune - Music
tune_up_car	Tune-Up - Car
tunnel	Tunnel
tunnel_ahead	Tunnel Ahead
tunnel_entrance	Tunnel Entrance
tunnel_of_love	Tunnel Of Love
tunnel_under_construction	Tunnel  - Under Construction
turkey_a	Turkey - 1
turkey_b	Turkey - 2
turn	Turn
turn_signal	Turn Signal
turn_the_page	Turn The Page
turnpike_entrance	Turnpike Entrance
turtle	Turtle
tutor	Tutor
tutorial	Tutorial
tuxedo	Tuxedo
tv	TV
tv_repairman	TV Repairman
tv_stand	TV Stand
tweezers	Tweezers
twelve	Twelve
twentieth_anniversary	Twentieth Anniversary
twenty_fifth_anniversary	Twenty-Fifth Anniversary
twice	Twice
twig	Twig
twin	Twin
twine	Twine
twirl	Twirl
twist	Twist
twister	Twister - Weather
two	Two
two_hundred_feet	Two Hundred Feet
two_way_left_turn	Two-Way Left Turn
two_way_road	Two-Way Road
two_way_traffic	Two-Way Traffic
type	Type - Kind
typewriter	Typewriter
typhoon	Typhoon
typist	Typist
u	U
u_turn	U-Turn
ugly	Ugly
ultrasound	Ultrasound
umbrella_2	Umbrella
umbrella_stand	Umbrella Stand
umpire	Umpire
uncle	Uncle
unconscious	Unconscious
under	Under
under_construction	Under Construction
underground	Underground
underneath	Underneath
understand	Understand
underwear_a	Underwear - 1
underwear_b	Underwear - 2
unicycle	Unicycle
uniform	Uniform
union_work	Union - Work
unisex	Unisex
unit	Unit
unite	Unite
united_states	United States
universe	Universe
university	University
unless	Unless
until	Until
up	Up
upon	Upon
upper_management_1	Upper Management - 1
upper_management_2	Upper Management - 2
upset_stomach	Upset Stomach
urban_area	Urban Area
urge	Urge
urine	Urine
us	Us
use	Use
usher	Usher
usual	Usual
utah	Utah
utility_knife	Utility Knife
v	V
vacant	Vacant
vacation	Vacation
vaccination	Vaccination
vaccine	Vaccine
vacuum	Vacuum
vacuum_portable	Vacuum - Portable
vacuum_salesperson	Vacuum Salesperson
vagina	Vagina
vague	Vague
vain	Vain
valentine	Valentine
valet_parking	Valet Parking
valley	Valley
value	Value
vampire	Vampire
van	Van
vanilla	Vanilla
vanish	Vanish
vapor	Vapor
vary	Vary
vase	Vase
vasectomy	Vasectomy
vaseline	Vaseline
vcr	VCR
veal	Veal
vegetable	Vegetable
vegetable_peeler	Vegetable Peeler
vegetable_steamer	Vegetable Steamer
vehicle	Vehicle
vein	Vein
vending_machine	Vending Machine
vendor	Vendor
vent	Vent - Emotional Outburst
venture	Venture
verb	Verb
vermont	Vermont
verse	Verse
vertical	Vertical
very	Very
vessel	Vessel
vest	Vest
veterinarian	Veterinarian
veterinary	Veterinary
vibrate	Vibrate
vice_president	Vice President
vice_tool	Vice - Tool
victim	Victim
victor	Victor
video	Video
video_camera_1	Video Camera - 1
video_camera_2	Video Camera - 2
video_game	Video Game
video_store_clerk	Video Store Clerk
videographer	Videographer
videotape	Videotape
view	View
vigor	Vigor
village	Village
vine	Vine
vinegar	Vinegar
vinegar_and_oil	Vinegar And Oil
violent	Violent
violet	Violet
violin	Violin
virgin	Virgin
virginia	Virginia
virus	Virus
visible	Visible
vision	Vision
visit	Visit
visiting_hours	Visiting Hours
visitor_parking	Visitor Parking
visitors	Visitors
visual_impairment	Visual Impairment
vital	Vital
vitamin	Vitamin
vitamin_c	Vitamin C
vocabulary	Vocabulary
vocation	Vocation
voice	Voice
volcano	Volcano
volleyball	Volleyball
volleyball_player	Volleyball Player
volt_ohm_meter	Volt Ohm Meter
volume	Volume
volunteer	Volunteer
vomit	Vomit
vote	Vote
voyage	Voyage
w	W
waddle	Waddle
waffle	Waffle
waffle_maker	Waffle Maker
wag	Wag
wagon	Wagon
wail	Wail
waist	Waist
wait	Wait
waited_too_long	Waited Too Long
waiter	Waiter
waiting_room	Waiting Room
waiting_room_anxiety	Waiting Room Anxiety
wake	Wake - From Sleep
walk	Walk
walker_medical	Walker - Medical
walking_stick	Walking Stick
wall	Wall
wall_clock	Clock - Wall
wall_rock	Wall - Rock
wallet	Wallet - 1
wallet_2	Wallet - 2
wallpaper	Wallpaper
wallpaper_hanger	Wallpaper Hanger
walnut	Walnut
walrus	Walrus
wander	Wander
want	Want
war	War
ware	Ware
warm	Warm
warm_front	Warm Front
warn	Warn
warning_lights	Warning Lights
was	Was
wash	Wash
washer_flat_hardware	Washer - Flat - Hardware
washer_hardware	Washer Hardware
washer_lock_washer	Washer - Lock Washer
washing_clothes	Washing - Clothes
washing_dishes	Washing - Dishes
washing_face	Washing - Face
washing_hands	Washing - Hands
washing_machine	Washing Machine
washing_window	Washing - Window
washington	Washington
wasp	Wasp
waste	Waste
watch_lcd	Watch - LCD
watch_repair_person	Watch Repair Person
watch_salesperson	Watch Salesperson
watch_timepiece	Watch - Timepiece
watch_waterproof	Watch - Waterproof
water	Water
water_barrel	Water Barrel
water_bed	Water Bed
water_bottle	Water Bottle
water_fountain	Water Fountain
water_skier	Water Skier
water_skiing	Water Skiing
water_skis	Water Skis
watering_can	Watering Can
watermelon	Watermelon
waterpark	Waterpark
waterslide	Water Slide
wave_water	Wave - Water
waver	Waiver
way	Way
we	We
weak	Weak
wealth	Wealth
weapon	Weapon
wear	Wear
weary	Weary
weather	Weather
weather_report	Weather Report
weather_reporter	Weather Reporter
weave	Weave
web	Web
wed	Wed
wedding_bells	Wedding Bells
wedding_consultant	Wedding Consultant
wedding_day	Wedding Day
wedding_gown	Wedding Gown
wedding_portrait	Wedding Portrait
wedding_reception	Wedding Reception
wedding_ring	Wedding Ring
wedding_vows	Wedding Vows
wednesday	Wednesday
wee	Wee
week	Week
weekly	Weekly
weep	Weep
weigh	Weigh
weighing_in	Weighing In
weight_control	Weight Control
weight_lifting	Weight Lifting
weight_limit	Weight  Limit
weight_limit_10_tons	Weight Limit - 10 Tons
weight_limit_15_tons	Weight Limit - 15 Tons
weight_limit_20_tons	Weight Limit - 20 Tons
weight_limit_40_tons	Weight Limit - 40 Tons
weights	Weights
weiner	Wiener
weird	Weird
welcome	Welcome
welcome_back	Welcome Back
welcome_home	Welcome Home
weld	Weld
welder	Welder
welder_mask	Welder Mask
welding	Welding
welding_machine	Welding Machine
well	Well - Water
wench	Winch
went	Went
were	Were
west	West
west_virginia	West Virginia
wet	Wet
what	What
wheel	Wheel
wheel_barrow	Wheel Barrow
wheelchair	Wheelchair
when	When
where	Where
whew	Whew
which	Which
while	While
whine	Whine
whip	Whip
whirl	Whirl
whirlwind	Whirlwind
whisk_broom	Whisk Broom
whiskey	Whiskey
whisper	Whisper
whistle	Whistle
white	White
who	Who
whole	Whole
whom	Whom
whose	Whose
why	Why
wicked	Wicked
wide	Wide
width_limitation	Width Limitation
wife	Wife
wig	Wig
wiggle	Wiggle
wild	Wild
will	Will - Shall
will_not	Will Not
win	Win
wind	Wind - Air Movement
wind_chime	Wind Chime
winding_road	Winding Road
window	Window
window_washer	Window Washer
windy	Windy
wine	Wine
wing	Wing - For Flying
wing_nut_hardware	Wing Nut - Hardware
wink	Wink
winter	Winter
wipe	Wipe
wire	Wire
wire_cutter	Wire Cutter
wire_stripper	Wire Stripper
wisconsin	Wisconsin
wise	Wise
wish	Wish
wit	Wit
witch	Witch
with	With
withdraw	Withdraw
without	Without
witness	Witness
wolf	Wolf
woman	Woman
women	Women
womens_blazer	Women's Blazer
won	Won
wonder	Wonder
wood	Wood
word	Word
word_scramble_puzzle	Word Scramble Puzzle
work	Work
work_area_ahead	Work Area Ahead
work_area_fine	Work Area Fine
workbench	Workbench
worker	Worker
workshop	Workshop
world	World
world_travel	World Travel
worm	Worm
worry	Worry
worse	Worse
worship	Worship
worst	Worst
worth	Worth
would	Would
wound	Wound
wow	Wow
wrap	Wrap
wreath	Wreath
wreck	Wreck
wrecking_ball	Wrecking Ball
wrench	Wrench
wrench_allen	Wrench - Allen
wrench_box_end	Wrench - Box End
wrench_combination	Wrench - Combination
wrench_crescent	Wrench - Crescent
wrench_open_end	Wrench - Open End
wrench_pipe	Wrench - Pipe
wrench_ratchet	Wrench - Ratchet
wrench_tire	Wrench - Tire
wrestle	Wrestle
wrestler	Wrestler
wring	Wring
wrist	Wrist
writer	Writer
wrong	Wrong
wrong_way	Wrong Way
wyoming	Wyoming
x	X
x_ray	X-ray
x_ray_interpretation	X-ray Interpretation
x_ray_machine	X-ray Machine
x_ray_technician	X-ray Technician
xerox	Xerox
XL_size	XL - Size
XXL_size	XXL - Size
XXXL_size	XXXL - Size
xylophone	Xylophone
y	Y
yak	Yak - Animal
yard	Yard - Land Space
yard_measurement	Yard - Measurement
yard_sale	Yard Sale
yawn	Yawn
year	Year
yearbook	Yearbook
yell	Yell
yellow	Yellow
yes	Yes
yesterday	Yesterday
yet	Yet
yield	Yield - Give Way
yield_to_pedestrians	Yield To Pedestrians
yogurt	Yogurt
yonder	Yonder
you	You
young	Young
your	Your
yoyo	Yoyo
z	Z
zebra	Zebra
zero	Zero
zip	Zip - Close Zipper
zipper	Zipper
zone	Zone
zoo	Zoo
zoom	Zoom